Localización;Nacionalidad;Fecha;Ambos;Hombres;Mujeres
España;Todas las nacionalidades;31/12/2021;55393;23949;31444
España;Afganistán;31/12/2021;5;4;1
España;Albania;31/12/2021;96;42;54
España;Andorra;31/12/2021;20;6;14
España;Angola;31/12/2021;68;45;23
España;Antigua y Barbuda;31/12/2021;4;1;3
España;Arabia Saudí;31/12/2021;156;122;34
España;Argelia;31/12/2021;529;283;246
España;Argentina;31/12/2021;1452;650;802
España;Armenia;31/12/2021;42;15;27
España;Australia;31/12/2021;143;76;67
España;Azerbaiyán;31/12/2021;66;43;23
España;Bahamas;31/12/2021;4;2;2
España;Bahrein;31/12/2021;14;14;0
España;Bangladés;31/12/2021;36;18;18
España;Barbados;31/12/2021;8;2;6
España;Belice;31/12/2021;1;0;1
España;Benín;31/12/2021;19;15;4
España;Bielorrusia;31/12/2021;132;45;87
España;Bolivia;31/12/2021;552;230;322
España;Bosnia-Herzegovina;31/12/2021;18;6;12
España;Botsuana;31/12/2021;4;1;3
España;Brasil;31/12/2021;1082;469;613
España;Brunei;31/12/2021;1;0;1
España;Burkina Faso;31/12/2021;5;4;1
España;Burundi;31/12/2021;11;10;1
España;Bután;31/12/2021;2;2;0
España;Cabo Verde;31/12/2021;16;8;8
España;Camboya;31/12/2021;0;0;0
España;Camerún;31/12/2021;135;69;66
España;Canadá;31/12/2021;482;209;273
España;Chad;31/12/2021;4;4;0
España;Chile;31/12/2021;2044;934;1110
España;China;31/12/2021;5304;1963;3341
España;Colombia;31/12/2021;4753;2010;2743
España;Comores;31/12/2021;0;0;0
España;Congo;31/12/2021;11;9;2
España;Corea del Norte;31/12/2021;2;1;1
España;Corea del Sur;31/12/2021;455;234;221
España;Costa de Marfil;31/12/2021;41;30;11
España;Costa Rica;31/12/2021;401;172;229
España;Cuba;31/12/2021;1438;634;804
España;Dominica;31/12/2021;4;3;1
España;Ecuador;31/12/2021;2337;1110;1227
España;Egipto;31/12/2021;404;259;145
España;El Salvador;31/12/2021;426;194;232
España;Emiratos Árabes Unidos;31/12/2021;23;15;8
España;Eritrea;31/12/2021;0;0;0
España;Estados Unidos;31/12/2021;6990;2156;4834
España;Etiopía;31/12/2021;31;23;8
España;Filipinas;31/12/2021;706;215;491
España;Fiyi;31/12/2021;0;0;0
España;Gabón;31/12/2021;10;6;4
España;Gambia;31/12/2021;8;6;2
España;Georgia;31/12/2021;114;59;55
España;Ghana;31/12/2021;46;28;18
España;Granada;31/12/2021;3;3;0
España;Guatemala;31/12/2021;363;174;189
España;Guinea;31/12/2021;7;4;3
España;Guinea Bissau;31/12/2021;3;2;1
España;Guinea Ecuatorial;31/12/2021;694;292;402
España;Guyana;31/12/2021;2;1;1
España;Haití;31/12/2021;78;51;27
España;Honduras;31/12/2021;502;233;269
España;India;31/12/2021;1222;729;493
España;Indonesia;31/12/2021;127;74;53
España;Irak;31/12/2021;172;121;51
España;Irán;31/12/2021;518;222;296
España;Islas Salomón;31/12/2021;0;0;0
España;Israel;31/12/2021;93;55;38
España;Jamaica;31/12/2021;32;9;23
España;Japón;31/12/2021;560;323;237
España;Jordania;31/12/2021;229;134;95
España;Kazajistán;31/12/2021;417;155;262
España;Kenia;31/12/2021;90;43;47
España;Kirguistán;31/12/2021;51;15;36
España;Kuwait;31/12/2021;20;13;7
España;Laos;31/12/2021;0;0;0
España;Lesoto;31/12/2021;1;0;1
España;Líbano;31/12/2021;417;237;180
España;Liberia;31/12/2021;3;3;0
España;Libia;31/12/2021;68;50;18
España;Macedonia;31/12/2021;23;9;14
España;Madagascar;31/12/2021;17;7;10
España;Malasia;31/12/2021;88;46;42
España;Malaui;31/12/2021;3;1;2
España;Maldivas;31/12/2021;15;12;3
España;Mali;31/12/2021;19;14;5
España;Marruecos;31/12/2021;3984;2147;1837
España;Mauricio;31/12/2021;7;3;4
España;Mauritania;31/12/2021;46;34;12
España;México;31/12/2021;2435;1010;1425
España;Micronesia;31/12/2021;0;0;0
España;Moldavia;31/12/2021;13;7;6
España;Mónaco;31/12/2021;1;0;1
España;Mongolia;31/12/2021;4;2;2
España;Montenegro;31/12/2021;21;10;11
España;Mozambique;31/12/2021;48;30;18
España;Myanmar;31/12/2021;13;6;7
España;Namibia;31/12/2021;7;4;3
España;Nepal;31/12/2021;32;14;18
España;Nicaragua;31/12/2021;152;78;74
España;Níger;31/12/2021;2;2;0
España;Nigeria;31/12/2021;231;169;62
España;Nueva Zelanda;31/12/2021;23;13;10
España;Oceanía (No consta país);31/12/2021;0;0;0
España;Omán;31/12/2021;72;64;8
España;Pakistán;31/12/2021;143;105;38
España;Palestina;31/12/2021;62;43;19
España;Panamá;31/12/2021;568;240;328
España;Papúa Nueva Guinea;31/12/2021;0;0;0
España;Paraguay;31/12/2021;211;81;130
España;Perú;31/12/2021;2964;1195;1769
España;Qatar;31/12/2021;19;15;4
España;Reino Unido;31/12/2021;1164;421;743
España;Rep. Centroafricana;31/12/2021;0;0;0
España;Rep. Dem. del Congo;31/12/2021;32;24;8
España;República Dominicana;31/12/2021;751;230;521
España;Ruanda;31/12/2021;10;5;5
España;Rusia;31/12/2021;1704;544;1160
España;Samoa;31/12/2021;0;0;0
España;San Cristóbal y Nieves;31/12/2021;3;1;2
España;San Marino;31/12/2021;1;1;0
España;San Vicente y Granadinas;31/12/2021;0;0;0
España;Santa Lucía;31/12/2021;1;0;1
España;Santo Tomé y Príncipe;31/12/2021;0;0;0
España;Senegal;31/12/2021;50;37;13
España;Serbia;31/12/2021;106;37;69
España;Seychelles;31/12/2021;3;2;1
España;Sierra Leona;31/12/2021;2;1;1
España;Singapur;31/12/2021;38;20;18
España;Siria;31/12/2021;94;58;36
España;Somalia;31/12/2021;3;3;0
España;Sri Lanka;31/12/2021;27;18;9
España;Suazilandia;31/12/2021;2;0;2
España;Sudáfrica;31/12/2021;111;46;65
España;Sudán;31/12/2021;22;18;4
España;Surinam;31/12/2021;0;0;0
España;Tailandia;31/12/2021;77;31;46
España;Taiwán;31/12/2021;456;212;244
España;Tanzania;31/12/2021;44;33;11
España;Tayikistán;31/12/2021;7;4;3
España;Togo;31/12/2021;11;9;2
España;Trinidad y Tobago;31/12/2021;19;6;13
España;Túnez;31/12/2021;455;284;171
España;Turkmenistán;31/12/2021;4;3;1
España;Turquía;31/12/2021;537;256;281
España;Ucrania;31/12/2021;620;213;407
España;Uganda;31/12/2021;20;15;5
España;Uruguay;31/12/2021;197;90;107
España;Uzbekistán;31/12/2021;30;16;14
España;Vanuatu;31/12/2021;1;0;1
España;Venezuela;31/12/2021;1045;464;581
España;Vietnam;31/12/2021;127;41;86
España;Yemen;31/12/2021;12;12;0
España;Yibuti;31/12/2021;4;3;1
España;Zambia;31/12/2021;15;11;4
España;Zimbabue;31/12/2021;38;20;18
España;Todas las nacionalidades;31/12/2020;3293887;1411416;1882471
España;Afganistán;31/12/2020;7;6;1
España;Albania;31/12/2020;70;33;37
España;Andorra;31/12/2020;29;14;15
España;Angola;31/12/2020;55;28;27
España;Antigua y Barbuda;31/12/2020;1;1;0
España;Arabia Saudí;31/12/2020;66;45;21
España;Argelia;31/12/2020;414;232;182
España;Argentina;31/12/2020;763;351;412
España;Armenia;31/12/2020;30;11;19
España;Australia;31/12/2020;117;58;59
España;Azerbaiyán;31/12/2020;61;40;21
España;Bahamas;31/12/2020;5;2;3
España;Bahrein;31/12/2020;6;5;1
España;Bangladés;31/12/2020;31;19;12
España;Barbados;31/12/2020;5;1;4
España;Belice;31/12/2020;5;2;3
España;Benín;31/12/2020;8;8;0
España;Bielorrusia;31/12/2020;108;43;65
España;Bolivia;31/12/2020;451;185;266
España;Bosnia-Herzegovina;31/12/2020;13;6;7
España;Botsuana;31/12/2020;1;0;1
España;Brasil;31/12/2020;952;389;563
España;Brunei;31/12/2020;2;0;2
España;Burkina Faso;31/12/2020;6;4;2
España;Burundi;31/12/2020;10;9;1
España;Bután;31/12/2020;2;2;0
España;Cabo Verde;31/12/2020;4;2;2
España;Camboya;31/12/2020;1;0;1
España;Camerún;31/12/2020;125;73;52
España;Canadá;31/12/2020;259;108;151
España;Chad;31/12/2020;0;0;0
España;Chile;31/12/2020;1070;510;560
España;China;31/12/2020;4436;1597;2839
España;Colombia;31/12/2020;2803;1204;1599
España;Comores;31/12/2020;1;1;0
España;Congo;31/12/2020;6;2;4
España;Corea del Norte;31/12/2020;2;2;0
España;Corea del Sur;31/12/2020;485;245;240
España;Costa de Marfil;31/12/2020;33;26;7
España;Costa Rica;31/12/2020;227;106;121
España;Cuba;31/12/2020;805;362;443
España;Dominica;31/12/2020;2;2;0
España;Ecuador;31/12/2020;1719;796;923
España;Egipto;31/12/2020;286;176;110
España;El Salvador;31/12/2020;280;139;141
España;Emiratos Árabes Unidos;31/12/2020;9;7;2
España;Eritrea;31/12/2020;1;0;1
España;Estados Unidos;31/12/2020;3597;1201;2396
España;Etiopía;31/12/2020;25;17;8
España;Filipinas;31/12/2020;455;142;313
España;Fiyi;31/12/2020;1;1;0
España;Gabón;31/12/2020;6;5;1
España;Gambia;31/12/2020;7;6;1
España;Georgia;31/12/2020;62;28;34
España;Ghana;31/12/2020;31;16;15
España;Granada;31/12/2020;2;1;1
España;Guatemala;31/12/2020;250;117;133
España;Guinea;31/12/2020;4;2;2
España;Guinea Bissau;31/12/2020;1;1;0
España;Guinea Ecuatorial;31/12/2020;491;219;272
España;Guyana;31/12/2020;0;0;0
España;Haití;31/12/2020;65;45;20
España;Honduras;31/12/2020;348;162;186
España;India;31/12/2020;675;462;213
España;Indonesia;31/12/2020;78;49;29
España;Irak;31/12/2020;79;67;12
España;Irán;31/12/2020;426;195;231
España;Islas Salomón;31/12/2020;0;0;0
España;Israel;31/12/2020;63;37;26
España;Jamaica;31/12/2020;25;6;19
España;Japón;31/12/2020;260;158;102
España;Jordania;31/12/2020;153;85;68
España;Kazajistán;31/12/2020;227;85;142
España;Kenia;31/12/2020;62;30;32
España;Kirguistán;31/12/2020;28;8;20
España;Kuwait;31/12/2020;9;8;1
España;Laos;31/12/2020;0;0;0
España;Lesoto;31/12/2020;0;0;0
España;Líbano;31/12/2020;296;178;118
España;Liberia;31/12/2020;3;2;1
España;Libia;31/12/2020;63;42;21
España;Macedonia;31/12/2020;21;6;15
España;Madagascar;31/12/2020;3;1;2
España;Malasia;31/12/2020;36;16;20
España;Malaui;31/12/2020;4;3;1
España;Maldivas;31/12/2020;11;9;2
España;Mali;31/12/2020;18;10;8
España;Marruecos;31/12/2020;2665;1389;1276
España;Mauricio;31/12/2020;5;2;3
España;Mauritania;31/12/2020;21;19;2
España;México;31/12/2020;1366;582;784
España;Micronesia;31/12/2020;0;0;0
España;Moldavia;31/12/2020;4;2;2
España;Mónaco;31/12/2020;2;0;2
España;Mongolia;31/12/2020;1;1;0
España;Montenegro;31/12/2020;13;6;7
España;Mozambique;31/12/2020;20;14;6
España;Myanmar;31/12/2020;7;4;3
España;Namibia;31/12/2020;6;2;4
España;Nepal;31/12/2020;33;18;15
España;Nicaragua;31/12/2020;132;68;64
España;Níger;31/12/2020;1;1;0
España;Nigeria;31/12/2020;82;58;24
España;Nueva Zelanda;31/12/2020;16;7;9
España;Oceanía (No consta país);31/12/2020;0;0;0
España;Omán;31/12/2020;27;24;3
España;Pakistán;31/12/2020;71;51;20
España;Palestina;31/12/2020;34;24;10
España;Panamá;31/12/2020;271;112;159
España;Papúa Nueva Guinea;31/12/2020;0;0;0
España;Paraguay;31/12/2020;115;52;63
España;Perú;31/12/2020;1525;646;879
España;Qatar;31/12/2020;8;8;0
España;Reino Unido;31/12/2020;8;2;6
España;Rep. Centroafricana;31/12/2020;3;3;0
España;Rep. Dem. del Congo;31/12/2020;43;33;10
España;República Dominicana;31/12/2020;508;181;327
España;Ruanda;31/12/2020;4;1;3
España;Rusia;31/12/2020;1463;475;988
España;Samoa;31/12/2020;0;0;0
España;San Cristóbal y Nieves;31/12/2020;0;0;0
España;San Marino;31/12/2020;0;0;0
España;San Vicente y Granadinas;31/12/2020;0;0;0
España;Santa Lucía;31/12/2020;1;1;0
España;Santo Tomé y Príncipe;31/12/2020;2;1;1
España;Senegal;31/12/2020;44;32;12
España;Serbia;31/12/2020;67;21;46
España;Seychelles;31/12/2020;3;2;1
España;Sierra Leona;31/12/2020;4;3;1
España;Singapur;31/12/2020;19;7;12
España;Siria;31/12/2020;66;48;18
España;Somalia;31/12/2020;3;2;1
España;Sri Lanka;31/12/2020;16;11;5
España;Suazilandia;31/12/2020;0;0;0
España;Sudáfrica;31/12/2020;72;23;49
España;Sudán;31/12/2020;14;9;5
España;Surinam;31/12/2020;0;0;0
España;Tailandia;31/12/2020;44;20;24
España;Taiwán;31/12/2020;383;179;204
España;Tanzania;31/12/2020;37;26;11
España;Tayikistán;31/12/2020;3;1;2
España;Togo;31/12/2020;5;3;2
España;Trinidad y Tobago;31/12/2020;15;3;12
España;Túnez;31/12/2020;216;117;99
España;Turkmenistán;31/12/2020;6;5;1
España;Turquía;31/12/2020;267;116;151
España;Ucrania;31/12/2020;522;160;362
España;Uganda;31/12/2020;21;15;6
España;Uruguay;31/12/2020;161;87;74
España;Uzbekistán;31/12/2020;19;13;6
España;Vanuatu;31/12/2020;1;0;1
España;Venezuela;31/12/2020;1028;431;597
España;Vietnam;31/12/2020;155;57;98
España;Yemen;31/12/2020;6;5;1
España;Yibuti;31/12/2020;4;3;1
España;Zambia;31/12/2020;8;5;3
España;Zimbabue;31/12/2020;18;3;15
España;Todas las nacionalidades;31/12/2019;1629273;697975;931298
España;Afganistán;31/12/2019;10;7;3
España;Albania;31/12/2019;100;42;58
España;Andorra;31/12/2019;65;29;36
España;Angola;31/12/2019;66;35;31
España;Antigua y Barbuda;31/12/2019;7;1;6
España;Arabia Saudí;31/12/2019;161;116;45
España;Argelia;31/12/2019;455;299;156
España;Argentina;31/12/2019;1459;606;853
España;Armenia;31/12/2019;39;16;23
España;Australia;31/12/2019;244;128;116
España;Azerbaiyán;31/12/2019;82;55;27
España;Bahamas;31/12/2019;12;4;8
España;Bahrein;31/12/2019;15;13;2
España;Bangladés;31/12/2019;51;35;16
España;Barbados;31/12/2019;5;0;5
España;Belice;31/12/2019;4;1;3
España;Benín;31/12/2019;10;10;0
España;Bielorrusia;31/12/2019;107;29;78
España;Bolivia;31/12/2019;888;369;519
España;Bosnia-Herzegovina;31/12/2019;24;9;15
España;Botsuana;31/12/2019;5;2;3
España;Brasil;31/12/2019;1806;762;1044
España;Brunei;31/12/2019;0;0;0
España;Burkina Faso;31/12/2019;7;6;1
España;Burundi;31/12/2019;12;10;2
España;Bután;31/12/2019;5;3;2
España;Cabo Verde;31/12/2019;30;14;16
España;Camboya;31/12/2019;3;1;2
España;Camerún;31/12/2019;120;70;50
España;Canadá;31/12/2019;449;164;285
España;Chad;31/12/2019;1;1;0
España;Chile;31/12/2019;1989;912;1077
España;China;31/12/2019;8068;2843;5225
España;Colombia;31/12/2019;4983;2068;2915
España;Comores;31/12/2019;1;1;0
España;Congo;31/12/2019;7;0;7
España;Corea del Norte;31/12/2019;10;10;0
España;Corea del Sur;31/12/2019;925;420;505
España;Costa de Marfil;31/12/2019;42;33;9
España;Costa Rica;31/12/2019;469;202;267
España;Cuba;31/12/2019;940;451;489
España;Dominica;31/12/2019;2;2;0
España;Ecuador;31/12/2019;3375;1553;1822
España;Egipto;31/12/2019;421;289;132
España;El Salvador;31/12/2019;426;215;211
España;Emiratos Árabes Unidos;31/12/2019;9;7;2
España;Eritrea;31/12/2019;0;0;0
España;Estados Unidos;31/12/2019;6754;2263;4491
España;Etiopía;31/12/2019;28;18;10
España;Filipinas;31/12/2019;513;176;337
España;Fiyi;31/12/2019;1;1;0
España;Gabón;31/12/2019;11;5;6
España;Gambia;31/12/2019;16;14;2
España;Georgia;31/12/2019;145;71;74
España;Ghana;31/12/2019;83;42;41
España;Granada;31/12/2019;2;1;1
España;Guatemala;31/12/2019;387;168;219
España;Guinea;31/12/2019;6;3;3
España;Guinea Bissau;31/12/2019;2;2;0
España;Guinea Ecuatorial;31/12/2019;686;315;371
España;Guyana;31/12/2019;1;1;0
España;Haití;31/12/2019;56;36;20
España;Honduras;31/12/2019;573;234;339
España;India;31/12/2019;1084;756;328
España;Indonesia;31/12/2019;147;95;52
España;Irak;31/12/2019;100;83;17
España;Irán;31/12/2019;556;271;285
España;Islas Salomón;31/12/2019;0;0;0
España;Israel;31/12/2019;92;59;33
España;Jamaica;31/12/2019;30;7;23
España;Japón;31/12/2019;846;401;445
España;Jordania;31/12/2019;234;135;99
España;Kazajistán;31/12/2019;450;182;268
España;Kenia;31/12/2019;89;39;50
España;Kirguistán;31/12/2019;55;24;31
España;Kuwait;31/12/2019;18;15;3
España;Laos;31/12/2019;1;1;0
España;Lesoto;31/12/2019;1;1;0
España;Líbano;31/12/2019;374;244;130
España;Liberia;31/12/2019;5;3;2
España;Libia;31/12/2019;130;100;30
España;Macedonia;31/12/2019;23;8;15
España;Madagascar;31/12/2019;12;6;6
España;Malasia;31/12/2019;66;35;31
España;Malaui;31/12/2019;8;4;4
España;Maldivas;31/12/2019;15;11;4
España;Mali;31/12/2019;24;18;6
España;Marruecos;31/12/2019;2664;1367;1297
España;Mauricio;31/12/2019;9;5;4
España;Mauritania;31/12/2019;40;30;10
España;México;31/12/2019;2854;1247;1607
España;Micronesia;31/12/2019;0;0;0
España;Moldavia;31/12/2019;10;1;9
España;Mónaco;31/12/2019;2;0;2
España;Mongolia;31/12/2019;5;1;4
España;Montenegro;31/12/2019;22;12;10
España;Mozambique;31/12/2019;33;21;12
España;Myanmar;31/12/2019;7;2;5
España;Namibia;31/12/2019;9;4;5
España;Nepal;31/12/2019;43;26;17
España;Nicaragua;31/12/2019;234;128;106
España;Níger;31/12/2019;4;3;1
España;Nigeria;31/12/2019;96;50;46
España;Nueva Zelanda;31/12/2019;43;16;27
España;Oceanía (No consta país);31/12/2019;0;0;0
España;Omán;31/12/2019;39;38;1
España;Pakistán;31/12/2019;130;97;33
España;Palestina;31/12/2019;61;37;24
España;Panamá;31/12/2019;495;217;278
España;Papúa Nueva Guinea;31/12/2019;0;0;0
España;Paraguay;31/12/2019;203;81;122
España;Perú;31/12/2019;2781;1118;1663
España;Qatar;31/12/2019;10;10;0
España;Reino Unido;31/12/2019;0;0;0
España;Rep. Centroafricana;31/12/2019;2;2;0
España;Rep. Dem. del Congo;31/12/2019;51;38;13
España;República Dominicana;31/12/2019;1078;345;733
España;Ruanda;31/12/2019;6;4;2
España;Rusia;31/12/2019;1653;533;1120
España;Samoa;31/12/2019;0;0;0
España;San Cristóbal y Nieves;31/12/2019;1;0;1
España;San Marino;31/12/2019;0;0;0
España;San Vicente y Granadinas;31/12/2019;0;0;0
España;Santa Lucía;31/12/2019;3;1;2
España;Santo Tomé y Príncipe;31/12/2019;3;2;1
España;Senegal;31/12/2019;68;43;25
España;Serbia;31/12/2019;106;39;67
España;Seychelles;31/12/2019;4;3;1
España;Sierra Leona;31/12/2019;7;6;1
España;Singapur;31/12/2019;31;12;19
España;Siria;31/12/2019;98;67;31
España;Somalia;31/12/2019;3;1;2
España;Sri Lanka;31/12/2019;12;8;4
España;Suazilandia;31/12/2019;2;0;2
España;Sudáfrica;31/12/2019;123;48;75
España;Sudán;31/12/2019;22;11;11
España;Surinam;31/12/2019;0;0;0
España;Tailandia;31/12/2019;83;44;39
España;Taiwán;31/12/2019;728;286;442
España;Tanzania;31/12/2019;30;18;12
España;Tayikistán;31/12/2019;7;3;4
España;Togo;31/12/2019;13;8;5
España;Trinidad y Tobago;31/12/2019;33;9;24
España;Túnez;31/12/2019;224;111;113
España;Turkmenistán;31/12/2019;11;11;0
España;Turquía;31/12/2019;594;285;309
España;Ucrania;31/12/2019;706;231;475
España;Uganda;31/12/2019;28;17;11
España;Uruguay;31/12/2019;307;144;163
España;Uzbekistán;31/12/2019;43;24;19
España;Vanuatu;31/12/2019;0;0;0
España;Venezuela;31/12/2019;1536;679;857
España;Vietnam;31/12/2019;259;89;170
España;Yemen;31/12/2019;23;17;6
España;Yibuti;31/12/2019;4;3;1
España;Zambia;31/12/2019;10;6;4
España;Zimbabue;31/12/2019;30;15;15
España;Todas las nacionalidades;31/12/2018;785002;336305;448697
España;Afganistán;31/12/2018;10;7;3
España;Albania;31/12/2018;85;35;50
España;Andorra;31/12/2018;55;27;28
España;Angola;31/12/2018;60;34;26
España;Antigua y Barbuda;31/12/2018;2;1;1
España;Arabia Saudí;31/12/2018;158;114;44
España;Argelia;31/12/2018;440;286;154
España;Argentina;31/12/2018;1235;548;687
España;Armenia;31/12/2018;34;18;16
España;Australia;31/12/2018;249;112;137
España;Azerbaiyán;31/12/2018;63;44;19
España;Bahamas;31/12/2018;4;0;4
España;Bahrein;31/12/2018;18;18;0
España;Bangladés;31/12/2018;36;24;12
España;Barbados;31/12/2018;8;3;5
España;Belice;31/12/2018;2;0;2
España;Benín;31/12/2018;14;11;3
España;Bielorrusia;31/12/2018;102;21;81
España;Bolivia;31/12/2018;845;367;478
España;Bosnia-Herzegovina;31/12/2018;27;12;15
España;Botsuana;31/12/2018;4;2;2
España;Brasil;31/12/2018;1855;789;1066
España;Brunei;31/12/2018;0;0;0
España;Burkina Faso;31/12/2018;4;2;2
España;Burundi;31/12/2018;11;9;2
España;Bután;31/12/2018;3;3;0
España;Cabo Verde;31/12/2018;19;10;9
España;Camboya;31/12/2018;2;1;1
España;Camerún;31/12/2018;79;52;27
España;Canadá;31/12/2018;466;183;283
España;Chad;31/12/2018;1;1;0
España;Chile;31/12/2018;1848;901;947
España;China;31/12/2018;8445;2987;5458
España;Colombia;31/12/2018;4540;1956;2584
España;Comores;31/12/2018;1;1;0
España;Congo;31/12/2018;6;4;2
España;Corea del Norte;31/12/2018;11;11;0
España;Corea del Sur;31/12/2018;959;430;529
España;Costa de Marfil;31/12/2018;36;28;8
España;Costa Rica;31/12/2018;475;229;246
España;Cuba;31/12/2018;639;302;337
España;Dominica;31/12/2018;4;1;3
España;Ecuador;31/12/2018;3545;1613;1932
España;Egipto;31/12/2018;378;270;108
España;El Salvador;31/12/2018;427;216;211
España;Emiratos Árabes Unidos;31/12/2018;8;5;3
España;Eritrea;31/12/2018;3;3;0
España;Estados Unidos;31/12/2018;6850;2248;4602
España;Etiopía;31/12/2018;26;12;14
España;Filipinas;31/12/2018;402;136;266
España;Fiyi;31/12/2018;1;1;0
España;Gabón;31/12/2018;18;7;11
España;Gambia;31/12/2018;16;13;3
España;Georgia;31/12/2018;104;49;55
España;Ghana;31/12/2018;65;38;27
España;Granada;31/12/2018;0;0;0
España;Guatemala;31/12/2018;371;171;200
España;Guinea;31/12/2018;5;3;2
España;Guinea Bissau;31/12/2018;14;11;3
España;Guinea Ecuatorial;31/12/2018;717;351;366
España;Guyana;31/12/2018;1;1;0
España;Haití;31/12/2018;51;28;23
España;Honduras;31/12/2018;635;259;376
España;India;31/12/2018;786;561;225
España;Indonesia;31/12/2018;112;75;37
España;Irak;31/12/2018;90;70;20
España;Irán;31/12/2018;531;247;284
España;Islas Salomón;31/12/2018;0;0;0
España;Israel;31/12/2018;100;56;44
España;Jamaica;31/12/2018;18;4;14
España;Japón;31/12/2018;831;404;427
España;Jordania;31/12/2018;179;107;72
España;Kazajistán;31/12/2018;319;141;178
España;Kenia;31/12/2018;69;38;31
España;Kirguistán;31/12/2018;25;8;17
España;Kuwait;31/12/2018;27;22;5
España;Laos;31/12/2018;0;0;0
España;Lesoto;31/12/2018;0;0;0
España;Líbano;31/12/2018;331;216;115
España;Liberia;31/12/2018;4;2;2
España;Libia;31/12/2018;236;198;38
España;Macedonia;31/12/2018;29;6;23
España;Madagascar;31/12/2018;10;4;6
España;Malasia;31/12/2018;53;22;31
España;Malaui;31/12/2018;4;2;2
España;Maldivas;31/12/2018;6;4;2
España;Mali;31/12/2018;23;17;6
España;Marruecos;31/12/2018;1846;827;1019
España;Mauricio;31/12/2018;6;4;2
España;Mauritania;31/12/2018;28;22;6
España;México;31/12/2018;2913;1259;1654
España;Micronesia;31/12/2018;0;0;0
España;Moldavia;31/12/2018;6;1;5
España;Mónaco;31/12/2018;3;1;2
España;Mongolia;31/12/2018;6;0;6
España;Montenegro;31/12/2018;20;10;10
España;Mozambique;31/12/2018;25;21;4
España;Myanmar;31/12/2018;4;2;2
España;Namibia;31/12/2018;12;5;7
España;Nepal;31/12/2018;37;23;14
España;Nicaragua;31/12/2018;222;106;116
España;Níger;31/12/2018;4;4;0
España;Nigeria;31/12/2018;87;51;36
España;Nueva Zelanda;31/12/2018;58;28;30
España;Oceanía (No consta país);31/12/2018;0;0;0
España;Omán;31/12/2018;29;28;1
España;Pakistán;31/12/2018;80;69;11
España;Palestina;31/12/2018;63;46;17
España;Panamá;31/12/2018;503;204;299
España;Papúa Nueva Guinea;31/12/2018;0;0;0
España;Paraguay;31/12/2018;174;78;96
España;Perú;31/12/2018;2371;964;1407
España;Qatar;31/12/2018;6;6;0
España;Reino Unido;31/12/2018;0;0;0
España;Rep. Centroafricana;31/12/2018;2;2;0
España;Rep. Dem. del Congo;31/12/2018;64;55;9
España;República Dominicana;31/12/2018;1210;407;803
España;Ruanda;31/12/2018;10;8;2
España;Rusia;31/12/2018;1586;475;1111
España;Samoa;31/12/2018;1;1;0
España;San Cristóbal y Nieves;31/12/2018;0;0;0
España;San Marino;31/12/2018;0;0;0
España;San Vicente y Granadinas;31/12/2018;0;0;0
España;Santa Lucía;31/12/2018;2;0;2
España;Santo Tomé y Príncipe;31/12/2018;2;2;0
España;Senegal;31/12/2018;72;47;25
España;Serbia;31/12/2018;126;40;86
España;Seychelles;31/12/2018;5;3;2
España;Sierra Leona;31/12/2018;6;4;2
España;Singapur;31/12/2018;20;7;13
España;Siria;31/12/2018;71;49;22
España;Somalia;31/12/2018;3;1;2
España;Sri Lanka;31/12/2018;11;9;2
España;Suazilandia;31/12/2018;1;0;1
España;Sudáfrica;31/12/2018;118;49;69
España;Sudán;31/12/2018;17;10;7
España;Surinam;31/12/2018;0;0;0
España;Tailandia;31/12/2018;66;31;35
España;Taiwán;31/12/2018;798;331;467
España;Tanzania;31/12/2018;29;16;13
España;Tayikistán;31/12/2018;6;2;4
España;Togo;31/12/2018;13;7;6
España;Trinidad y Tobago;31/12/2018;15;3;12
España;Túnez;31/12/2018;167;73;94
España;Turkmenistán;31/12/2018;10;9;1
España;Turquía;31/12/2018;633;304;329
España;Ucrania;31/12/2018;760;261;499
España;Uganda;31/12/2018;18;12;6
España;Uruguay;31/12/2018;214;103;111
España;Uzbekistán;31/12/2018;20;13;7
España;Vanuatu;31/12/2018;0;0;0
España;Venezuela;31/12/2018;1766;807;959
España;Vietnam;31/12/2018;286;97;189
España;Yemen;31/12/2018;13;11;2
España;Yibuti;31/12/2018;0;0;0
España;Zambia;31/12/2018;5;1;4
España;Zimbabue;31/12/2018;22;11;11
España;Todas las nacionalidades;31/12/2017;364028;156031;207997
España;Afganistán;31/12/2017;20;19;1
España;Albania;31/12/2017;90;29;61
España;Andorra;31/12/2017;49;28;21
España;Angola;31/12/2017;61;33;28
España;Antigua y Barbuda;31/12/2017;1;0;1
España;Arabia Saudí;31/12/2017;129;91;38
España;Argelia;31/12/2017;374;226;148
España;Argentina;31/12/2017;1092;446;646
España;Armenia;31/12/2017;48;19;29
España;Australia;31/12/2017;235;103;132
España;Azerbaiyán;31/12/2017;70;45;25
España;Bahamas;31/12/2017;7;3;4
España;Bahrein;31/12/2017;14;14;0
España;Bangladés;31/12/2017;40;23;17
España;Barbados;31/12/2017;9;4;5
España;Belice;31/12/2017;1;0;1
España;Benín;31/12/2017;17;15;2
España;Bielorrusia;31/12/2017;103;24;79
España;Bolivia;31/12/2017;746;324;422
España;Bosnia-Herzegovina;31/12/2017;33;14;19
España;Botsuana;31/12/2017;1;0;1
España;Brasil;31/12/2017;1795;794;1001
España;Brunei;31/12/2017;0;0;0
España;Burkina Faso;31/12/2017;5;5;0
España;Burundi;31/12/2017;12;10;2
España;Bután;31/12/2017;4;2;2
España;Cabo Verde;31/12/2017;28;13;15
España;Camboya;31/12/2017;3;2;1
España;Camerún;31/12/2017;78;51;27
España;Canadá;31/12/2017;368;148;220
España;Chad;31/12/2017;1;1;0
España;Chile;31/12/2017;1806;861;945
España;China;31/12/2017;8604;2961;5643
España;Colombia;31/12/2017;4131;1792;2339
España;Comores;31/12/2017;1;1;0
España;Congo;31/12/2017;12;11;1
España;Corea del Norte;31/12/2017;9;9;0
España;Corea del Sur;31/12/2017;1030;454;576
España;Costa de Marfil;31/12/2017;39;28;11
España;Costa Rica;31/12/2017;503;234;269
España;Cuba;31/12/2017;527;246;281
España;Dominica;31/12/2017;2;0;2
España;Ecuador;31/12/2017;3658;1651;2007
España;Egipto;31/12/2017;378;266;112
España;El Salvador;31/12/2017;407;208;199
España;Emiratos Árabes Unidos;31/12/2017;8;3;5
España;Eritrea;31/12/2017;3;3;0
España;Estados Unidos;31/12/2017;6435;2124;4311
España;Etiopía;31/12/2017;27;16;11
España;Filipinas;31/12/2017;219;96;123
España;Fiyi;31/12/2017;0;0;0
España;Gabón;31/12/2017;17;8;9
España;Gambia;31/12/2017;12;9;3
España;Georgia;31/12/2017;106;50;56
España;Ghana;31/12/2017;83;42;41
España;Granada;31/12/2017;1;0;1
España;Guatemala;31/12/2017;328;136;192
España;Guinea;31/12/2017;8;6;2
España;Guinea Bissau;31/12/2017;2;1;1
España;Guinea Ecuatorial;31/12/2017;701;353;348
España;Guyana;31/12/2017;2;0;2
España;Haití;31/12/2017;33;21;12
España;Honduras;31/12/2017;580;260;320
España;India;31/12/2017;706;494;212
España;Indonesia;31/12/2017;116;70;46
España;Irak;31/12/2017;92;69;23
España;Irán;31/12/2017;571;265;306
España;Islas Salomón;31/12/2017;0;0;0
España;Israel;31/12/2017;86;46;40
España;Jamaica;31/12/2017;10;3;7
España;Japón;31/12/2017;796;377;419
España;Jordania;31/12/2017;165;102;63
España;Kazajistán;31/12/2017;321;128;193
España;Kenia;31/12/2017;54;33;21
España;Kirguistán;31/12/2017;20;10;10
España;Kuwait;31/12/2017;27;18;9
España;Laos;31/12/2017;1;1;0
España;Lesoto;31/12/2017;1;0;1
España;Líbano;31/12/2017;286;184;102
España;Liberia;31/12/2017;3;1;2
España;Libia;31/12/2017;182;144;38
España;Macedonia;31/12/2017;27;8;19
España;Madagascar;31/12/2017;9;5;4
España;Malasia;31/12/2017;82;43;39
España;Malaui;31/12/2017;4;2;2
España;Maldivas;31/12/2017;4;3;1
España;Mali;31/12/2017;14;11;3
España;Marruecos;31/12/2017;1800;898;902
España;Mauricio;31/12/2017;8;3;5
España;Mauritania;31/12/2017;26;20;6
España;México;31/12/2017;2953;1288;1665
España;Micronesia;31/12/2017;1;1;0
España;Moldavia;31/12/2017;6;1;5
España;Mónaco;31/12/2017;4;2;2
España;Mongolia;31/12/2017;9;3;6
España;Montenegro;31/12/2017;19;11;8
España;Mozambique;31/12/2017;25;18;7
España;Myanmar;31/12/2017;7;1;6
España;Namibia;31/12/2017;9;2;7
España;Nepal;31/12/2017;32;19;13
España;Nicaragua;31/12/2017;181;78;103
España;Níger;31/12/2017;11;11;0
España;Nigeria;31/12/2017;78;59;19
España;Nueva Zelanda;31/12/2017;54;25;29
España;Oceanía (No consta país);31/12/2017;0;0;0
España;Omán;31/12/2017;9;8;1
España;Pakistán;31/12/2017;90;54;36
España;Palestina;31/12/2017;65;47;18
España;Panamá;31/12/2017;516;208;308
España;Papúa Nueva Guinea;31/12/2017;0;0;0
España;Paraguay;31/12/2017;238;91;147
España;Perú;31/12/2017;2380;985;1395
España;Qatar;31/12/2017;10;9;1
España;Reino Unido;31/12/2017;0;0;0
España;Rep. Centroafricana;31/12/2017;1;1;0
España;Rep. Dem. del Congo;31/12/2017;57;50;7
España;República Dominicana;31/12/2017;1428;456;972
España;Ruanda;31/12/2017;11;10;1
España;Rusia;31/12/2017;1752;523;1229
España;Samoa;31/12/2017;0;0;0
España;San Cristóbal y Nieves;31/12/2017;0;0;0
España;San Marino;31/12/2017;0;0;0
España;San Vicente y Granadinas;31/12/2017;0;0;0
España;Santa Lucía;31/12/2017;2;0;2
España;Santo Tomé y Príncipe;31/12/2017;0;0;0
España;Senegal;31/12/2017;68;43;25
España;Serbia;31/12/2017;132;38;94
España;Seychelles;31/12/2017;4;2;2
España;Sierra Leona;31/12/2017;6;5;1
España;Singapur;31/12/2017;23;8;15
España;Siria;31/12/2017;81;55;26
España;Somalia;31/12/2017;0;0;0
España;Sri Lanka;31/12/2017;9;6;3
España;Suazilandia;31/12/2017;1;0;1
España;Sudáfrica;31/12/2017;81;32;49
España;Sudán;31/12/2017;17;13;4
España;Surinam;31/12/2017;0;0;0
España;Tailandia;31/12/2017;63;26;37
España;Taiwán;31/12/2017;705;278;427
España;Tanzania;31/12/2017;33;19;14
España;Tayikistán;31/12/2017;3;1;2
España;Togo;31/12/2017;5;3;2
España;Trinidad y Tobago;31/12/2017;17;4;13
España;Túnez;31/12/2017;133;58;75
España;Turkmenistán;31/12/2017;8;6;2
España;Turquía;31/12/2017;705;332;373
España;Ucrania;31/12/2017;856;312;544
España;Uganda;31/12/2017;24;14;10
España;Uruguay;31/12/2017;220;89;131
España;Uzbekistán;31/12/2017;33;19;14
España;Vanuatu;31/12/2017;0;0;0
España;Venezuela;31/12/2017;1880;817;1063
España;Vietnam;31/12/2017;330;110;220
España;Yemen;31/12/2017;15;11;4
España;Yibuti;31/12/2017;1;1;0
España;Zambia;31/12/2017;9;7;2
España;Zimbabue;31/12/2017;19;9;10
España;Todas las nacionalidades;31/12/2016;154041;66239;87802
España;Afganistán;31/12/2016;4;3;1
España;Albania;31/12/2016;90;34;56
España;Andorra;31/12/2016;55;32;23
España;Angola;31/12/2016;85;43;42
España;Antigua y Barbuda;31/12/2016;0;0;0
España;Arabia Saudí;31/12/2016;169;111;58
España;Argelia;31/12/2016;375;223;152
España;Argentina;31/12/2016;857;361;496
España;Armenia;31/12/2016;48;21;27
España;Australia;31/12/2016;229;109;120
España;Azerbaiyán;31/12/2016;112;68;44
España;Bahamas;31/12/2016;5;0;5
España;Bahrein;31/12/2016;18;16;2
España;Bangladés;31/12/2016;43;30;13
España;Barbados;31/12/2016;4;2;2
España;Belice;31/12/2016;0;0;0
España;Benín;31/12/2016;16;14;2
España;Bielorrusia;31/12/2016;129;36;93
España;Bolivia;31/12/2016;635;275;360
España;Bosnia-Herzegovina;31/12/2016;24;8;16
España;Botsuana;31/12/2016;0;0;0
España;Brasil;31/12/2016;1586;686;900
España;Brunei;31/12/2016;0;0;0
España;Burkina Faso;31/12/2016;10;9;1
España;Burundi;31/12/2016;13;9;4
España;Bután;31/12/2016;2;1;1
España;Cabo Verde;31/12/2016;19;9;10
España;Camboya;31/12/2016;2;1;1
España;Camerún;31/12/2016;74;46;28
España;Canadá;31/12/2016;383;151;232
España;Chad;31/12/2016;1;1;0
España;Chile;31/12/2016;1591;778;813
España;China;31/12/2016;8152;2852;5300
España;Colombia;31/12/2016;4191;1846;2345
España;Comores;31/12/2016;2;1;1
España;Congo;31/12/2016;20;12;8
España;Corea del Norte;31/12/2016;0;0;0
España;Corea del Sur;31/12/2016;1095;469;626
España;Costa de Marfil;31/12/2016;41;32;9
España;Costa Rica;31/12/2016;453;192;261
España;Cuba;31/12/2016;409;193;216
España;Dominica;31/12/2016;0;0;0
España;Ecuador;31/12/2016;3362;1551;1811
España;Egipto;31/12/2016;381;287;94
España;El Salvador;31/12/2016;383;196;187
España;Emiratos Árabes Unidos;31/12/2016;25;23;2
España;Eritrea;31/12/2016;2;2;0
España;Estados Unidos;31/12/2016;6308;2135;4173
España;Etiopía;31/12/2016;28;16;12
España;Filipinas;31/12/2016;175;77;98
España;Fiyi;31/12/2016;0;0;0
España;Gabón;31/12/2016;21;9;12
España;Gambia;31/12/2016;3;2;1
España;Georgia;31/12/2016;85;35;50
España;Ghana;31/12/2016;55;31;24
España;Granada;31/12/2016;0;0;0
España;Guatemala;31/12/2016;350;165;185
España;Guinea;31/12/2016;8;4;4
España;Guinea Bissau;31/12/2016;7;4;3
España;Guinea Ecuatorial;31/12/2016;698;336;362
España;Guyana;31/12/2016;1;0;1
España;Haití;31/12/2016;36;26;10
España;Honduras;31/12/2016;514;228;286
España;India;31/12/2016;722;512;210
España;Indonesia;31/12/2016;101;70;31
España;Irak;31/12/2016;95;68;27
España;Irán;31/12/2016;456;223;233
España;Islas Salomón;31/12/2016;0;0;0
España;Israel;31/12/2016;75;46;29
España;Jamaica;31/12/2016;8;3;5
España;Japón;31/12/2016;866;382;484
España;Jordania;31/12/2016;152;89;63
España;Kazajistán;31/12/2016;318;127;191
España;Kenia;31/12/2016;45;19;26
España;Kirguistán;31/12/2016;34;15;19
España;Kuwait;31/12/2016;18;10;8
España;Laos;31/12/2016;2;0;2
España;Lesoto;31/12/2016;1;1;0
España;Líbano;31/12/2016;239;163;76
España;Liberia;31/12/2016;3;0;3
España;Libia;31/12/2016;127;89;38
España;Macedonia;31/12/2016;35;14;21
España;Madagascar;31/12/2016;11;6;5
España;Malasia;31/12/2016;107;65;42
España;Malaui;31/12/2016;2;1;1
España;Maldivas;31/12/2016;3;2;1
España;Mali;31/12/2016;11;6;5
España;Marruecos;31/12/2016;1742;847;895
España;Mauricio;31/12/2016;8;4;4
España;Mauritania;31/12/2016;30;22;8
España;México;31/12/2016;3178;1406;1772
España;Micronesia;31/12/2016;0;0;0
España;Moldavia;31/12/2016;8;1;7
España;Mónaco;31/12/2016;1;0;1
España;Mongolia;31/12/2016;12;5;7
España;Montenegro;31/12/2016;27;11;16
España;Mozambique;31/12/2016;30;21;9
España;Myanmar;31/12/2016;5;2;3
España;Namibia;31/12/2016;0;0;0
España;Nepal;31/12/2016;28;16;12
España;Nicaragua;31/12/2016;166;77;89
España;Níger;31/12/2016;9;8;1
España;Nigeria;31/12/2016;67;43;24
España;Nueva Zelanda;31/12/2016;45;24;21
España;Oceanía (No consta país);31/12/2016;0;0;0
España;Omán;31/12/2016;30;17;13
España;Pakistán;31/12/2016;61;46;15
España;Palestina;31/12/2016;57;37;20
España;Panamá;31/12/2016;467;212;255
España;Papúa Nueva Guinea;31/12/2016;0;0;0
España;Paraguay;31/12/2016;469;177;292
España;Perú;31/12/2016;2001;881;1120
España;Qatar;31/12/2016;19;16;3
España;Reino Unido;31/12/2016;0;0;0
España;Rep. Centroafricana;31/12/2016;4;3;1
España;Rep. Dem. del Congo;31/12/2016;39;38;1
España;República Dominicana;31/12/2016;1771;595;1176
España;Ruanda;31/12/2016;18;15;3
España;Rusia;31/12/2016;1984;625;1359
España;Samoa;31/12/2016;0;0;0
España;San Cristóbal y Nieves;31/12/2016;0;0;0
España;San Marino;31/12/2016;2;1;1
España;San Vicente y Granadinas;31/12/2016;1;0;1
España;Santa Lucía;31/12/2016;2;0;2
España;Santo Tomé y Príncipe;31/12/2016;1;0;1
España;Senegal;31/12/2016;66;49;17
España;Serbia;31/12/2016;125;47;78
España;Seychelles;31/12/2016;2;0;2
España;Sierra Leona;31/12/2016;2;2;0
España;Singapur;31/12/2016;26;13;13
España;Siria;31/12/2016;119;74;45
España;Somalia;31/12/2016;2;0;2
España;Sri Lanka;31/12/2016;6;3;3
España;Suazilandia;31/12/2016;1;1;0
España;Sudáfrica;31/12/2016;72;35;37
España;Sudán;31/12/2016;6;4;2
España;Surinam;31/12/2016;1;1;0
España;Tailandia;31/12/2016;74;27;47
España;Taiwán;31/12/2016;525;179;346
España;Tanzania;31/12/2016;24;14;10
España;Tayikistán;31/12/2016;7;5;2
España;Togo;31/12/2016;10;8;2
España;Trinidad y Tobago;31/12/2016;17;4;13
España;Túnez;31/12/2016;120;59;61
España;Turkmenistán;31/12/2016;6;4;2
España;Turquía;31/12/2016;612;304;308
España;Ucrania;31/12/2016;931;351;580
España;Uganda;31/12/2016;12;10;2
España;Uruguay;31/12/2016;172;80;92
España;Uzbekistán;31/12/2016;47;26;21
España;Vanuatu;31/12/2016;0;0;0
España;Venezuela;31/12/2016;2291;951;1340
España;Vietnam;31/12/2016;328;122;206
España;Yemen;31/12/2016;12;8;4
España;Yibuti;31/12/2016;2;2;0
España;Zambia;31/12/2016;2;2;0
España;Zimbabue;31/12/2016;12;8;4
España;Todas las nacionalidades;31/12/2015;49656;21492;28164
España;Afganistán;31/12/2015;5;5;0
España;Albania;31/12/2015;51;17;34
España;Andorra;31/12/2015;58;25;33
España;Angola;31/12/2015;87;59;28
España;Antigua y Barbuda;31/12/2015;1;0;1
España;Arabia Saudí;31/12/2015;154;104;50
España;Argelia;31/12/2015;339;186;153
España;Argentina;31/12/2015;641;280;361
España;Armenia;31/12/2015;51;19;32
España;Australia;31/12/2015;188;88;100
España;Azerbaiyán;31/12/2015;96;69;27
España;Bahamas;31/12/2015;12;5;7
España;Bahrein;31/12/2015;7;1;6
España;Bangladés;31/12/2015;33;26;7
España;Barbados;31/12/2015;3;2;1
España;Belice;31/12/2015;0;0;0
España;Benín;31/12/2015;19;17;2
España;Bielorrusia;31/12/2015;122;36;86
España;Bolivia;31/12/2015;532;259;273
España;Bosnia-Herzegovina;31/12/2015;24;9;15
España;Botsuana;31/12/2015;2;2;0
España;Brasil;31/12/2015;2427;1037;1390
España;Brunei;31/12/2015;1;0;1
España;Burkina Faso;31/12/2015;12;10;2
España;Burundi;31/12/2015;13;10;3
España;Bután;31/12/2015;2;1;1
España;Cabo Verde;31/12/2015;26;14;12
España;Camboya;31/12/2015;11;6;5
España;Camerún;31/12/2015;70;42;28
España;Canadá;31/12/2015;378;131;247
España;Chad;31/12/2015;2;2;0
España;Chile;31/12/2015;1463;735;728
España;China;31/12/2015;6444;2170;4274
España;Colombia;31/12/2015;3975;1790;2185
España;Comores;31/12/2015;3;1;2
España;Congo;31/12/2015;16;8;8
España;Corea del Norte;31/12/2015;1;1;0
España;Corea del Sur;31/12/2015;955;356;599
España;Costa de Marfil;31/12/2015;35;29;6
España;Costa Rica;31/12/2015;363;159;204
España;Cuba;31/12/2015;303;139;164
España;Dominica;31/12/2015;1;0;1
España;Ecuador;31/12/2015;2853;1342;1511
España;Egipto;31/12/2015;359;269;90
España;El Salvador;31/12/2015;292;145;147
España;Emiratos Árabes Unidos;31/12/2015;49;44;5
España;Eritrea;31/12/2015;1;1;0
España;Estados Unidos;31/12/2015;5629;1969;3660
España;Etiopía;31/12/2015;32;22;10
España;Filipinas;31/12/2015;159;73;86
España;Fiyi;31/12/2015;2;0;2
España;Gabón;31/12/2015;23;12;11
España;Gambia;31/12/2015;7;4;3
España;Georgia;31/12/2015;99;48;51
España;Ghana;31/12/2015;40;22;18
España;Granada;31/12/2015;0;0;0
España;Guatemala;31/12/2015;299;143;156
España;Guinea;31/12/2015;18;12;6
España;Guinea Bissau;31/12/2015;6;2;4
España;Guinea Ecuatorial;31/12/2015;688;346;342
España;Guyana;31/12/2015;1;1;0
España;Haití;31/12/2015;50;37;13
España;Honduras;31/12/2015;418;195;223
España;India;31/12/2015;604;440;164
España;Indonesia;31/12/2015;79;48;31
España;Irak;31/12/2015;90;60;30
España;Irán;31/12/2015;396;195;201
España;Islas Salomón;31/12/2015;0;0;0
España;Israel;31/12/2015;49;25;24
España;Jamaica;31/12/2015;7;1;6
España;Japón;31/12/2015;857;408;449
España;Jordania;31/12/2015;158;98;60
España;Kazajistán;31/12/2015;309;121;188
España;Kenia;31/12/2015;27;12;15
España;Kirguistán;31/12/2015;33;14;19
España;Kuwait;31/12/2015;10;7;3
España;Laos;31/12/2015;2;1;1
España;Lesoto;31/12/2015;1;0;1
España;Líbano;31/12/2015;174;108;66
España;Liberia;31/12/2015;4;1;3
España;Libia;31/12/2015;96;64;32
España;Macedonia;31/12/2015;40;15;25
España;Madagascar;31/12/2015;11;6;5
España;Malasia;31/12/2015;103;63;40
España;Malaui;31/12/2015;0;0;0
España;Maldivas;31/12/2015;3;1;2
España;Mali;31/12/2015;10;8;2
España;Marruecos;31/12/2015;1614;808;806
España;Mauricio;31/12/2015;7;4;3
España;Mauritania;31/12/2015;34;23;11
España;México;31/12/2015;3325;1571;1754
España;Micronesia;31/12/2015;0;0;0
España;Moldavia;31/12/2015;12;0;12
España;Mónaco;31/12/2015;0;0;0
España;Mongolia;31/12/2015;8;4;4
España;Montenegro;31/12/2015;23;10;13
España;Mozambique;31/12/2015;33;24;9
España;Myanmar;31/12/2015;0;0;0
España;Namibia;31/12/2015;1;1;0
España;Nepal;31/12/2015;23;14;9
España;Nicaragua;31/12/2015;158;81;77
España;Níger;31/12/2015;4;4;0
España;Nigeria;31/12/2015;66;50;16
España;Nueva Zelanda;31/12/2015;32;12;20
España;Oceanía (No consta país);31/12/2015;4;3;1
España;Omán;31/12/2015;16;12;4
España;Pakistán;31/12/2015;71;52;19
España;Palestina;31/12/2015;39;28;11
España;Panamá;31/12/2015;348;146;202
España;Papúa Nueva Guinea;31/12/2015;0;0;0
España;Paraguay;31/12/2015;199;86;113
España;Perú;31/12/2015;1949;888;1061
España;Qatar;31/12/2015;9;9;0
España;Reino Unido;31/12/2015;0;0;0
España;Rep. Centroafricana;31/12/2015;4;4;0
España;Rep. Dem. del Congo;31/12/2015;35;32;3
España;República Dominicana;31/12/2015;1070;345;725
España;Ruanda;31/12/2015;13;11;2
España;Rusia;31/12/2015;2113;712;1401
España;Samoa;31/12/2015;0;0;0
España;San Cristóbal y Nieves;31/12/2015;0;0;0
España;San Marino;31/12/2015;0;0;0
España;San Vicente y Granadinas;31/12/2015;1;0;1
España;Santa Lucía;31/12/2015;0;0;0
España;Santo Tomé y Príncipe;31/12/2015;0;0;0
España;Senegal;31/12/2015;56;41;15
España;Serbia;31/12/2015;124;52;72
España;Seychelles;31/12/2015;1;0;1
España;Sierra Leona;31/12/2015;2;2;0
España;Singapur;31/12/2015;24;10;14
España;Siria;31/12/2015;117;76;41
España;Somalia;31/12/2015;2;1;1
España;Sri Lanka;31/12/2015;3;2;1
España;Suazilandia;31/12/2015;2;1;1
España;Sudáfrica;31/12/2015;44;24;20
España;Sudán;31/12/2015;10;9;1
España;Surinam;31/12/2015;1;1;0
España;Tailandia;31/12/2015;68;29;39
España;Taiwán;31/12/2015;434;147;287
España;Tanzania;31/12/2015;14;8;6
España;Tayikistán;31/12/2015;29;18;11
España;Togo;31/12/2015;8;6;2
España;Trinidad y Tobago;31/12/2015;11;2;9
España;Túnez;31/12/2015;114;50;64
España;Turkmenistán;31/12/2015;13;7;6
España;Turquía;31/12/2015;550;270;280
España;Ucrania;31/12/2015;822;277;545
España;Uganda;31/12/2015;12;9;3
España;Uruguay;31/12/2015;109;59;50
España;Uzbekistán;31/12/2015;59;34;25
España;Vanuatu;31/12/2015;0;0;0
España;Venezuela;31/12/2015;2575;1089;1486
España;Vietnam;31/12/2015;201;81;120
España;Yemen;31/12/2015;8;7;1
España;Yibuti;31/12/2015;2;2;0
España;Zambia;31/12/2015;0;0;0
España;Zimbabue;31/12/2015;16;11;5
Castilla y León;Todas las nacionalidades;31/12/2021;3185;1426;1759
Castilla y León;Afganistán;31/12/2021;0;0;0
Castilla y León;Albania;31/12/2021;4;1;3
Castilla y León;Andorra;31/12/2021;1;0;1
Castilla y León;Angola;31/12/2021;8;5;3
Castilla y León;Antigua y Barbuda;31/12/2021;0;0;0
Castilla y León;Arabia Saudí;31/12/2021;3;3;0
Castilla y León;Argelia;31/12/2021;41;13;28
Castilla y León;Argentina;31/12/2021;61;31;30
Castilla y León;Armenia;31/12/2021;2;1;1
Castilla y León;Australia;31/12/2021;4;2;2
Castilla y León;Azerbaiyán;31/12/2021;2;1;1
Castilla y León;Bahamas;31/12/2021;0;0;0
Castilla y León;Bahrein;31/12/2021;4;4;0
Castilla y León;Bangladés;31/12/2021;3;2;1
Castilla y León;Barbados;31/12/2021;1;0;1
Castilla y León;Belice;31/12/2021;0;0;0
Castilla y León;Benín;31/12/2021;5;5;0
Castilla y León;Bielorrusia;31/12/2021;1;0;1
Castilla y León;Bolivia;31/12/2021;23;9;14
Castilla y León;Bosnia-Herzegovina;31/12/2021;1;0;1
Castilla y León;Botsuana;31/12/2021;0;0;0
Castilla y León;Brasil;31/12/2021;124;55;69
Castilla y León;Brunei;31/12/2021;0;0;0
Castilla y León;Burkina Faso;31/12/2021;2;2;0
Castilla y León;Burundi;31/12/2021;4;4;0
Castilla y León;Bután;31/12/2021;0;0;0
Castilla y León;Cabo Verde;31/12/2021;1;1;0
Castilla y León;Camboya;31/12/2021;0;0;0
Castilla y León;Camerún;31/12/2021;8;5;3
Castilla y León;Canadá;31/12/2021;18;12;6
Castilla y León;Chad;31/12/2021;0;0;0
Castilla y León;Chile;31/12/2021;66;32;34
Castilla y León;China;31/12/2021;645;242;403
Castilla y León;Colombia;31/12/2021;286;117;169
Castilla y León;Comores;31/12/2021;0;0;0
Castilla y León;Congo;31/12/2021;0;0;0
Castilla y León;Corea del Norte;31/12/2021;0;0;0
Castilla y León;Corea del Sur;31/12/2021;11;6;5
Castilla y León;Costa de Marfil;31/12/2021;4;3;1
Castilla y León;Costa Rica;31/12/2021;28;13;15
Castilla y León;Cuba;31/12/2021;60;20;40
Castilla y León;Dominica;31/12/2021;0;0;0
Castilla y León;Ecuador;31/12/2021;139;71;68
Castilla y León;Egipto;31/12/2021;22;10;12
Castilla y León;El Salvador;31/12/2021;34;18;16
Castilla y León;Emiratos Árabes Unidos;31/12/2021;1;1;0
Castilla y León;Eritrea;31/12/2021;0;0;0
Castilla y León;Estados Unidos;31/12/2021;198;63;135
Castilla y León;Etiopía;31/12/2021;0;0;0
Castilla y León;Filipinas;31/12/2021;20;12;8
Castilla y León;Fiyi;31/12/2021;0;0;0
Castilla y León;Gabón;31/12/2021;4;2;2
Castilla y León;Gambia;31/12/2021;1;1;0
Castilla y León;Georgia;31/12/2021;8;3;5
Castilla y León;Ghana;31/12/2021;2;1;1
Castilla y León;Granada;31/12/2021;0;0;0
Castilla y León;Guatemala;31/12/2021;22;10;12
Castilla y León;Guinea;31/12/2021;0;0;0
Castilla y León;Guinea Bissau;31/12/2021;0;0;0
Castilla y León;Guinea Ecuatorial;31/12/2021;85;34;51
Castilla y León;Guyana;31/12/2021;0;0;0
Castilla y León;Haití;31/12/2021;3;2;1
Castilla y León;Honduras;31/12/2021;42;22;20
Castilla y León;India;31/12/2021;61;35;26
Castilla y León;Indonesia;31/12/2021;7;4;3
Castilla y León;Irak;31/12/2021;23;20;3
Castilla y León;Irán;31/12/2021;21;10;11
Castilla y León;Islas Salomón;31/12/2021;0;0;0
Castilla y León;Israel;31/12/2021;2;2;0
Castilla y León;Jamaica;31/12/2021;3;1;2
Castilla y León;Japón;31/12/2021;44;19;25
Castilla y León;Jordania;31/12/2021;40;11;29
Castilla y León;Kazajistán;31/12/2021;17;9;8
Castilla y León;Kenia;31/12/2021;7;2;5
Castilla y León;Kirguistán;31/12/2021;1;1;0
Castilla y León;Kuwait;31/12/2021;1;1;0
Castilla y León;Laos;31/12/2021;0;0;0
Castilla y León;Lesoto;31/12/2021;0;0;0
Castilla y León;Líbano;31/12/2021;34;15;19
Castilla y León;Liberia;31/12/2021;0;0;0
Castilla y León;Libia;31/12/2021;3;2;1
Castilla y León;Macedonia;31/12/2021;0;0;0
Castilla y León;Madagascar;31/12/2021;1;0;1
Castilla y León;Malasia;31/12/2021;6;2;4
Castilla y León;Malaui;31/12/2021;0;0;0
Castilla y León;Maldivas;31/12/2021;1;1;0
Castilla y León;Mali;31/12/2021;0;0;0
Castilla y León;Marruecos;31/12/2021;247;124;123
Castilla y León;Mauricio;31/12/2021;1;0;1
Castilla y León;Mauritania;31/12/2021;0;0;0
Castilla y León;México;31/12/2021;140;63;77
Castilla y León;Micronesia;31/12/2021;0;0;0
Castilla y León;Moldavia;31/12/2021;0;0;0
Castilla y León;Mónaco;31/12/2021;0;0;0
Castilla y León;Mongolia;31/12/2021;2;0;2
Castilla y León;Montenegro;31/12/2021;2;2;0
Castilla y León;Mozambique;31/12/2021;2;2;0
Castilla y León;Myanmar;31/12/2021;0;0;0
Castilla y León;Namibia;31/12/2021;0;0;0
Castilla y León;Nepal;31/12/2021;4;2;2
Castilla y León;Nicaragua;31/12/2021;8;2;6
Castilla y León;Níger;31/12/2021;2;2;0
Castilla y León;Nigeria;31/12/2021;12;11;1
Castilla y León;Nueva Zelanda;31/12/2021;2;2;0
Castilla y León;Oceanía (No consta país);31/12/2021;0;0;0
Castilla y León;Omán;31/12/2021;25;21;4
Castilla y León;Pakistán;31/12/2021;7;6;1
Castilla y León;Palestina;31/12/2021;2;1;1
Castilla y León;Panamá;31/12/2021;32;13;19
Castilla y León;Papúa Nueva Guinea;31/12/2021;0;0;0
Castilla y León;Paraguay;31/12/2021;9;3;6
Castilla y León;Perú;31/12/2021;119;55;64
Castilla y León;Qatar;31/12/2021;3;3;0
Castilla y León;Reino Unido;31/12/2021;47;17;30
Castilla y León;Rep. Centroafricana;31/12/2021;0;0;0
Castilla y León;Rep. Dem. del Congo;31/12/2021;1;1;0
Castilla y León;República Dominicana;31/12/2021;44;16;28
Castilla y León;Ruanda;31/12/2021;0;0;0
Castilla y León;Rusia;31/12/2021;42;15;27
Castilla y León;Samoa;31/12/2021;0;0;0
Castilla y León;San Cristóbal y Nieves;31/12/2021;0;0;0
Castilla y León;San Marino;31/12/2021;0;0;0
Castilla y León;San Vicente y Granadinas;31/12/2021;0;0;0
Castilla y León;Santa Lucía;31/12/2021;0;0;0
Castilla y León;Santo Tomé y Príncipe;31/12/2021;0;0;0
Castilla y León;Senegal;31/12/2021;6;6;0
Castilla y León;Serbia;31/12/2021;3;2;1
Castilla y León;Seychelles;31/12/2021;0;0;0
Castilla y León;Sierra Leona;31/12/2021;0;0;0
Castilla y León;Singapur;31/12/2021;3;2;1
Castilla y León;Siria;31/12/2021;4;3;1
Castilla y León;Somalia;31/12/2021;0;0;0
Castilla y León;Sri Lanka;31/12/2021;1;1;0
Castilla y León;Suazilandia;31/12/2021;0;0;0
Castilla y León;Sudáfrica;31/12/2021;6;3;3
Castilla y León;Sudán;31/12/2021;2;2;0
Castilla y León;Surinam;31/12/2021;0;0;0
Castilla y León;Tailandia;31/12/2021;5;2;3
Castilla y León;Taiwán;31/12/2021;4;2;2
Castilla y León;Tanzania;31/12/2021;7;7;0
Castilla y León;Tayikistán;31/12/2021;0;0;0
Castilla y León;Togo;31/12/2021;1;1;0
Castilla y León;Trinidad y Tobago;31/12/2021;0;0;0
Castilla y León;Túnez;31/12/2021;9;5;4
Castilla y León;Turkmenistán;31/12/2021;2;2;0
Castilla y León;Turquía;31/12/2021;20;8;12
Castilla y León;Ucrania;31/12/2021;16;9;7
Castilla y León;Uganda;31/12/2021;1;1;0
Castilla y León;Uruguay;31/12/2021;3;1;2
Castilla y León;Uzbekistán;31/12/2021;1;0;1
Castilla y León;Vanuatu;31/12/2021;0;0;0
Castilla y León;Venezuela;31/12/2021;47;24;23
Castilla y León;Vietnam;31/12/2021;13;6;7
Castilla y León;Yemen;31/12/2021;0;0;0
Castilla y León;Yibuti;31/12/2021;0;0;0
Castilla y León;Zambia;31/12/2021;4;4;0
Castilla y León;Zimbabue;31/12/2021;0;0;0
Castilla y León;Todas las nacionalidades;31/12/2020;2467;1089;1378
Castilla y León;Afganistán;31/12/2020;0;0;0
Castilla y León;Albania;31/12/2020;3;3;0
Castilla y León;Andorra;31/12/2020;0;0;0
Castilla y León;Angola;31/12/2020;9;6;3
Castilla y León;Antigua y Barbuda;31/12/2020;1;1;0
Castilla y León;Arabia Saudí;31/12/2020;3;2;1
Castilla y León;Argelia;31/12/2020;28;11;17
Castilla y León;Argentina;31/12/2020;34;13;21
Castilla y León;Armenia;31/12/2020;1;1;0
Castilla y León;Australia;31/12/2020;6;4;2
Castilla y León;Azerbaiyán;31/12/2020;5;5;0
Castilla y León;Bahamas;31/12/2020;0;0;0
Castilla y León;Bahrein;31/12/2020;1;1;0
Castilla y León;Bangladés;31/12/2020;3;3;0
Castilla y León;Barbados;31/12/2020;1;0;1
Castilla y León;Belice;31/12/2020;0;0;0
Castilla y León;Benín;31/12/2020;3;3;0
Castilla y León;Bielorrusia;31/12/2020;2;1;1
Castilla y León;Bolivia;31/12/2020;35;12;23
Castilla y León;Bosnia-Herzegovina;31/12/2020;1;0;1
Castilla y León;Botsuana;31/12/2020;0;0;0
Castilla y León;Brasil;31/12/2020;125;50;75
Castilla y León;Brunei;31/12/2020;0;0;0
Castilla y León;Burkina Faso;31/12/2020;2;2;0
Castilla y León;Burundi;31/12/2020;4;4;0
Castilla y León;Bután;31/12/2020;0;0;0
Castilla y León;Cabo Verde;31/12/2020;0;0;0
Castilla y León;Camboya;31/12/2020;0;0;0
Castilla y León;Camerún;31/12/2020;4;3;1
Castilla y León;Canadá;31/12/2020;14;7;7
Castilla y León;Chad;31/12/2020;0;0;0
Castilla y León;Chile;31/12/2020;52;25;27
Castilla y León;China;31/12/2020;582;217;365
Castilla y León;Colombia;31/12/2020;198;75;123
Castilla y León;Comores;31/12/2020;0;0;0
Castilla y León;Congo;31/12/2020;0;0;0
Castilla y León;Corea del Norte;31/12/2020;0;0;0
Castilla y León;Corea del Sur;31/12/2020;13;3;10
Castilla y León;Costa de Marfil;31/12/2020;2;2;0
Castilla y León;Costa Rica;31/12/2020;20;12;8
Castilla y León;Cuba;31/12/2020;24;7;17
Castilla y León;Dominica;31/12/2020;0;0;0
Castilla y León;Ecuador;31/12/2020;118;52;66
Castilla y León;Egipto;31/12/2020;16;7;9
Castilla y León;El Salvador;31/12/2020;22;12;10
Castilla y León;Emiratos Árabes Unidos;31/12/2020;1;1;0
Castilla y León;Eritrea;31/12/2020;0;0;0
Castilla y León;Estados Unidos;31/12/2020;142;57;85
Castilla y León;Etiopía;31/12/2020;2;1;1
Castilla y León;Filipinas;31/12/2020;22;11;11
Castilla y León;Fiyi;31/12/2020;0;0;0
Castilla y León;Gabón;31/12/2020;3;2;1
Castilla y León;Gambia;31/12/2020;0;0;0
Castilla y León;Georgia;31/12/2020;8;3;5
Castilla y León;Ghana;31/12/2020;0;0;0
Castilla y León;Granada;31/12/2020;0;0;0
Castilla y León;Guatemala;31/12/2020;15;4;11
Castilla y León;Guinea;31/12/2020;0;0;0
Castilla y León;Guinea Bissau;31/12/2020;0;0;0
Castilla y León;Guinea Ecuatorial;31/12/2020;92;45;47
Castilla y León;Guyana;31/12/2020;0;0;0
Castilla y León;Haití;31/12/2020;5;2;3
Castilla y León;Honduras;31/12/2020;42;14;28
Castilla y León;India;31/12/2020;39;26;13
Castilla y León;Indonesia;31/12/2020;5;3;2
Castilla y León;Irak;31/12/2020;15;12;3
Castilla y León;Irán;31/12/2020;8;4;4
Castilla y León;Islas Salomón;31/12/2020;0;0;0
Castilla y León;Israel;31/12/2020;2;2;0
Castilla y León;Jamaica;31/12/2020;1;0;1
Castilla y León;Japón;31/12/2020;13;4;9
Castilla y León;Jordania;31/12/2020;32;7;25
Castilla y León;Kazajistán;31/12/2020;7;4;3
Castilla y León;Kenia;31/12/2020;4;2;2
Castilla y León;Kirguistán;31/12/2020;1;1;0
Castilla y León;Kuwait;31/12/2020;1;1;0
Castilla y León;Laos;31/12/2020;0;0;0
Castilla y León;Lesoto;31/12/2020;0;0;0
Castilla y León;Líbano;31/12/2020;22;8;14
Castilla y León;Liberia;31/12/2020;0;0;0
Castilla y León;Libia;31/12/2020;3;2;1
Castilla y León;Macedonia;31/12/2020;0;0;0
Castilla y León;Madagascar;31/12/2020;1;0;1
Castilla y León;Malasia;31/12/2020;3;1;2
Castilla y León;Malaui;31/12/2020;1;1;0
Castilla y León;Maldivas;31/12/2020;1;1;0
Castilla y León;Mali;31/12/2020;0;0;0
Castilla y León;Marruecos;31/12/2020;160;85;75
Castilla y León;Mauricio;31/12/2020;1;0;1
Castilla y León;Mauritania;31/12/2020;1;1;0
Castilla y León;México;31/12/2020;83;36;47
Castilla y León;Micronesia;31/12/2020;0;0;0
Castilla y León;Moldavia;31/12/2020;0;0;0
Castilla y León;Mónaco;31/12/2020;0;0;0
Castilla y León;Mongolia;31/12/2020;0;0;0
Castilla y León;Montenegro;31/12/2020;1;1;0
Castilla y León;Mozambique;31/12/2020;0;0;0
Castilla y León;Myanmar;31/12/2020;0;0;0
Castilla y León;Namibia;31/12/2020;0;0;0
Castilla y León;Nepal;31/12/2020;4;3;1
Castilla y León;Nicaragua;31/12/2020;7;6;1
Castilla y León;Níger;31/12/2020;1;1;0
Castilla y León;Nigeria;31/12/2020;0;0;0
Castilla y León;Nueva Zelanda;31/12/2020;1;0;1
Castilla y León;Oceanía (No consta país);31/12/2020;0;0;0
Castilla y León;Omán;31/12/2020;22;20;2
Castilla y León;Pakistán;31/12/2020;6;4;2
Castilla y León;Palestina;31/12/2020;2;1;1
Castilla y León;Panamá;31/12/2020;25;10;15
Castilla y León;Papúa Nueva Guinea;31/12/2020;0;0;0
Castilla y León;Paraguay;31/12/2020;9;5;4
Castilla y León;Perú;31/12/2020;81;38;43
Castilla y León;Qatar;31/12/2020;4;4;0
Castilla y León;Reino Unido;31/12/2020;0;0;0
Castilla y León;Rep. Centroafricana;31/12/2020;1;1;0
Castilla y León;Rep. Dem. del Congo;31/12/2020;2;2;0
Castilla y León;República Dominicana;31/12/2020;40;9;31
Castilla y León;Ruanda;31/12/2020;0;0;0
Castilla y León;Rusia;31/12/2020;43;18;25
Castilla y León;Samoa;31/12/2020;0;0;0
Castilla y León;San Cristóbal y Nieves;31/12/2020;0;0;0
Castilla y León;San Marino;31/12/2020;0;0;0
Castilla y León;San Vicente y Granadinas;31/12/2020;0;0;0
Castilla y León;Santa Lucía;31/12/2020;0;0;0
Castilla y León;Santo Tomé y Príncipe;31/12/2020;0;0;0
Castilla y León;Senegal;31/12/2020;3;2;1
Castilla y León;Serbia;31/12/2020;4;1;3
Castilla y León;Seychelles;31/12/2020;0;0;0
Castilla y León;Sierra Leona;31/12/2020;0;0;0
Castilla y León;Singapur;31/12/2020;0;0;0
Castilla y León;Siria;31/12/2020;2;2;0
Castilla y León;Somalia;31/12/2020;0;0;0
Castilla y León;Sri Lanka;31/12/2020;1;1;0
Castilla y León;Suazilandia;31/12/2020;0;0;0
Castilla y León;Sudáfrica;31/12/2020;3;0;3
Castilla y León;Sudán;31/12/2020;1;0;1
Castilla y León;Surinam;31/12/2020;0;0;0
Castilla y León;Tailandia;31/12/2020;4;2;2
Castilla y León;Taiwán;31/12/2020;4;3;1
Castilla y León;Tanzania;31/12/2020;8;5;3
Castilla y León;Tayikistán;31/12/2020;0;0;0
Castilla y León;Togo;31/12/2020;0;0;0
Castilla y León;Trinidad y Tobago;31/12/2020;0;0;0
Castilla y León;Túnez;31/12/2020;5;3;2
Castilla y León;Turkmenistán;31/12/2020;2;2;0
Castilla y León;Turquía;31/12/2020;18;7;11
Castilla y León;Ucrania;31/12/2020;14;10;4
Castilla y León;Uganda;31/12/2020;3;2;1
Castilla y León;Uruguay;31/12/2020;8;6;2
Castilla y León;Uzbekistán;31/12/2020;2;0;2
Castilla y León;Vanuatu;31/12/2020;0;0;0
Castilla y León;Venezuela;31/12/2020;53;28;25
Castilla y León;Vietnam;31/12/2020;15;7;8
Castilla y León;Yemen;31/12/2020;0;0;0
Castilla y León;Yibuti;31/12/2020;0;0;0
Castilla y León;Zambia;31/12/2020;0;0;0
Castilla y León;Zimbabue;31/12/2020;0;0;0
Castilla y León;Todas las nacionalidades;31/12/2019;3844;1634;2210
Castilla y León;Afganistán;31/12/2019;0;0;0
Castilla y León;Albania;31/12/2019;3;2;1
Castilla y León;Andorra;31/12/2019;1;1;0
Castilla y León;Angola;31/12/2019;11;7;4
Castilla y León;Antigua y Barbuda;31/12/2019;1;1;0
Castilla y León;Arabia Saudí;31/12/2019;5;5;0
Castilla y León;Argelia;31/12/2019;17;14;3
Castilla y León;Argentina;31/12/2019;57;25;32
Castilla y León;Armenia;31/12/2019;3;1;2
Castilla y León;Australia;31/12/2019;10;4;6
Castilla y León;Azerbaiyán;31/12/2019;4;4;0
Castilla y León;Bahamas;31/12/2019;1;0;1
Castilla y León;Bahrein;31/12/2019;0;0;0
Castilla y León;Bangladés;31/12/2019;2;2;0
Castilla y León;Barbados;31/12/2019;1;0;1
Castilla y León;Belice;31/12/2019;0;0;0
Castilla y León;Benín;31/12/2019;3;3;0
Castilla y León;Bielorrusia;31/12/2019;2;1;1
Castilla y León;Bolivia;31/12/2019;54;17;37
Castilla y León;Bosnia-Herzegovina;31/12/2019;3;1;2
Castilla y León;Botsuana;31/12/2019;0;0;0
Castilla y León;Brasil;31/12/2019;184;83;101
Castilla y León;Brunei;31/12/2019;0;0;0
Castilla y León;Burkina Faso;31/12/2019;2;2;0
Castilla y León;Burundi;31/12/2019;3;3;0
Castilla y León;Bután;31/12/2019;0;0;0
Castilla y León;Cabo Verde;31/12/2019;1;1;0
Castilla y León;Camboya;31/12/2019;0;0;0
Castilla y León;Camerún;31/12/2019;7;5;2
Castilla y León;Canadá;31/12/2019;13;3;10
Castilla y León;Chad;31/12/2019;0;0;0
Castilla y León;Chile;31/12/2019;62;31;31
Castilla y León;China;31/12/2019;1154;436;718
Castilla y León;Colombia;31/12/2019;271;111;160
Castilla y León;Comores;31/12/2019;0;0;0
Castilla y León;Congo;31/12/2019;0;0;0
Castilla y León;Corea del Norte;31/12/2019;0;0;0
Castilla y León;Corea del Sur;31/12/2019;44;18;26
Castilla y León;Costa de Marfil;31/12/2019;5;5;0
Castilla y León;Costa Rica;31/12/2019;34;17;17
Castilla y León;Cuba;31/12/2019;32;13;19
Castilla y León;Dominica;31/12/2019;0;0;0
Castilla y León;Ecuador;31/12/2019;189;78;111
Castilla y León;Egipto;31/12/2019;21;9;12
Castilla y León;El Salvador;31/12/2019;28;14;14
Castilla y León;Emiratos Árabes Unidos;31/12/2019;2;2;0
Castilla y León;Eritrea;31/12/2019;0;0;0
Castilla y León;Estados Unidos;31/12/2019;205;71;134
Castilla y León;Etiopía;31/12/2019;1;0;1
Castilla y León;Filipinas;31/12/2019;31;15;16
Castilla y León;Fiyi;31/12/2019;0;0;0
Castilla y León;Gabón;31/12/2019;3;3;0
Castilla y León;Gambia;31/12/2019;0;0;0
Castilla y León;Georgia;31/12/2019;17;6;11
Castilla y León;Ghana;31/12/2019;7;2;5
Castilla y León;Granada;31/12/2019;0;0;0
Castilla y León;Guatemala;31/12/2019;25;9;16
Castilla y León;Guinea;31/12/2019;0;0;0
Castilla y León;Guinea Bissau;31/12/2019;0;0;0
Castilla y León;Guinea Ecuatorial;31/12/2019;109;44;65
Castilla y León;Guyana;31/12/2019;0;0;0
Castilla y León;Haití;31/12/2019;10;6;4
Castilla y León;Honduras;31/12/2019;71;30;41
Castilla y León;India;31/12/2019;44;27;17
Castilla y León;Indonesia;31/12/2019;21;19;2
Castilla y León;Irak;31/12/2019;14;12;2
Castilla y León;Irán;31/12/2019;9;3;6
Castilla y León;Islas Salomón;31/12/2019;0;0;0
Castilla y León;Israel;31/12/2019;12;12;0
Castilla y León;Jamaica;31/12/2019;2;0;2
Castilla y León;Japón;31/12/2019;79;24;55
Castilla y León;Jordania;31/12/2019;36;10;26
Castilla y León;Kazajistán;31/12/2019;9;3;6
Castilla y León;Kenia;31/12/2019;3;1;2
Castilla y León;Kirguistán;31/12/2019;3;2;1
Castilla y León;Kuwait;31/12/2019;0;0;0
Castilla y León;Laos;31/12/2019;0;0;0
Castilla y León;Lesoto;31/12/2019;0;0;0
Castilla y León;Líbano;31/12/2019;11;5;6
Castilla y León;Liberia;31/12/2019;0;0;0
Castilla y León;Libia;31/12/2019;12;10;2
Castilla y León;Macedonia;31/12/2019;0;0;0
Castilla y León;Madagascar;31/12/2019;3;1;2
Castilla y León;Malasia;31/12/2019;3;2;1
Castilla y León;Malaui;31/12/2019;1;1;0
Castilla y León;Maldivas;31/12/2019;0;0;0
Castilla y León;Mali;31/12/2019;0;0;0
Castilla y León;Marruecos;31/12/2019;129;66;63
Castilla y León;Mauricio;31/12/2019;1;0;1
Castilla y León;Mauritania;31/12/2019;3;2;1
Castilla y León;México;31/12/2019;132;53;79
Castilla y León;Micronesia;31/12/2019;0;0;0
Castilla y León;Moldavia;31/12/2019;0;0;0
Castilla y León;Mónaco;31/12/2019;0;0;0
Castilla y León;Mongolia;31/12/2019;0;0;0
Castilla y León;Montenegro;31/12/2019;1;0;1
Castilla y León;Mozambique;31/12/2019;2;1;1
Castilla y León;Myanmar;31/12/2019;0;0;0
Castilla y León;Namibia;31/12/2019;0;0;0
Castilla y León;Nepal;31/12/2019;3;3;0
Castilla y León;Nicaragua;31/12/2019;14;9;5
Castilla y León;Níger;31/12/2019;2;2;0
Castilla y León;Nigeria;31/12/2019;2;1;1
Castilla y León;Nueva Zelanda;31/12/2019;4;2;2
Castilla y León;Oceanía (No consta país);31/12/2019;0;0;0
Castilla y León;Omán;31/12/2019;32;31;1
Castilla y León;Pakistán;31/12/2019;6;5;1
Castilla y León;Palestina;31/12/2019;1;0;1
Castilla y León;Panamá;31/12/2019;26;11;15
Castilla y León;Papúa Nueva Guinea;31/12/2019;0;0;0
Castilla y León;Paraguay;31/12/2019;15;8;7
Castilla y León;Perú;31/12/2019;138;63;75
Castilla y León;Qatar;31/12/2019;3;3;0
Castilla y León;Reino Unido;31/12/2019;0;0;0
Castilla y León;Rep. Centroafricana;31/12/2019;1;1;0
Castilla y León;Rep. Dem. del Congo;31/12/2019;7;6;1
Castilla y León;República Dominicana;31/12/2019;81;21;60
Castilla y León;Ruanda;31/12/2019;0;0;0
Castilla y León;Rusia;31/12/2019;41;12;29
Castilla y León;Samoa;31/12/2019;0;0;0
Castilla y León;San Cristóbal y Nieves;31/12/2019;0;0;0
Castilla y León;San Marino;31/12/2019;0;0;0
Castilla y León;San Vicente y Granadinas;31/12/2019;0;0;0
Castilla y León;Santa Lucía;31/12/2019;0;0;0
Castilla y León;Santo Tomé y Príncipe;31/12/2019;0;0;0
Castilla y León;Senegal;31/12/2019;3;1;2
Castilla y León;Serbia;31/12/2019;4;1;3
Castilla y León;Seychelles;31/12/2019;0;0;0
Castilla y León;Sierra Leona;31/12/2019;0;0;0
Castilla y León;Singapur;31/12/2019;1;0;1
Castilla y León;Siria;31/12/2019;2;2;0
Castilla y León;Somalia;31/12/2019;0;0;0
Castilla y León;Sri Lanka;31/12/2019;1;1;0
Castilla y León;Suazilandia;31/12/2019;0;0;0
Castilla y León;Sudáfrica;31/12/2019;5;1;4
Castilla y León;Sudán;31/12/2019;0;0;0
Castilla y León;Surinam;31/12/2019;0;0;0
Castilla y León;Tailandia;31/12/2019;4;1;3
Castilla y León;Taiwán;31/12/2019;52;9;43
Castilla y León;Tanzania;31/12/2019;10;6;4
Castilla y León;Tayikistán;31/12/2019;0;0;0
Castilla y León;Togo;31/12/2019;1;1;0
Castilla y León;Trinidad y Tobago;31/12/2019;2;1;1
Castilla y León;Túnez;31/12/2019;4;3;1
Castilla y León;Turkmenistán;31/12/2019;0;0;0
Castilla y León;Turquía;31/12/2019;27;12;15
Castilla y León;Ucrania;31/12/2019;15;7;8
Castilla y León;Uganda;31/12/2019;4;3;1
Castilla y León;Uruguay;31/12/2019;11;8;3
Castilla y León;Uzbekistán;31/12/2019;2;1;1
Castilla y León;Vanuatu;31/12/2019;0;0;0
Castilla y León;Venezuela;31/12/2019;61;31;30
Castilla y León;Vietnam;31/12/2019;20;8;12
Castilla y León;Yemen;31/12/2019;0;0;0
Castilla y León;Yibuti;31/12/2019;0;0;0
Castilla y León;Zambia;31/12/2019;0;0;0
Castilla y León;Zimbabue;31/12/2019;0;0;0
Castilla y León;Todas las nacionalidades;31/12/2018;3726;1574;2152
Castilla y León;Afganistán;31/12/2018;0;0;0
Castilla y León;Albania;31/12/2018;1;1;0
Castilla y León;Andorra;31/12/2018;2;1;1
Castilla y León;Angola;31/12/2018;9;6;3
Castilla y León;Antigua y Barbuda;31/12/2018;1;1;0
Castilla y León;Arabia Saudí;31/12/2018;5;4;1
Castilla y León;Argelia;31/12/2018;17;11;6
Castilla y León;Argentina;31/12/2018;41;17;24
Castilla y León;Armenia;31/12/2018;2;2;0
Castilla y León;Australia;31/12/2018;4;1;3
Castilla y León;Azerbaiyán;31/12/2018;4;3;1
Castilla y León;Bahamas;31/12/2018;1;0;1
Castilla y León;Bahrein;31/12/2018;0;0;0
Castilla y León;Bangladés;31/12/2018;3;2;1
Castilla y León;Barbados;31/12/2018;1;0;1
Castilla y León;Belice;31/12/2018;0;0;0
Castilla y León;Benín;31/12/2018;1;1;0
Castilla y León;Bielorrusia;31/12/2018;2;1;1
Castilla y León;Bolivia;31/12/2018;58;20;38
Castilla y León;Bosnia-Herzegovina;31/12/2018;1;0;1
Castilla y León;Botsuana;31/12/2018;0;0;0
Castilla y León;Brasil;31/12/2018;174;78;96
Castilla y León;Brunei;31/12/2018;0;0;0
Castilla y León;Burkina Faso;31/12/2018;1;1;0
Castilla y León;Burundi;31/12/2018;2;2;0
Castilla y León;Bután;31/12/2018;0;0;0
Castilla y León;Cabo Verde;31/12/2018;0;0;0
Castilla y León;Camboya;31/12/2018;0;0;0
Castilla y León;Camerún;31/12/2018;3;2;1
Castilla y León;Canadá;31/12/2018;17;8;9
Castilla y León;Chad;31/12/2018;0;0;0
Castilla y León;Chile;31/12/2018;62;31;31
Castilla y León;China;31/12/2018;1322;503;819
Castilla y León;Colombia;31/12/2018;242;108;134
Castilla y León;Comores;31/12/2018;0;0;0
Castilla y León;Congo;31/12/2018;0;0;0
Castilla y León;Corea del Norte;31/12/2018;0;0;0
Castilla y León;Corea del Sur;31/12/2018;58;31;27
Castilla y León;Costa de Marfil;31/12/2018;5;5;0
Castilla y León;Costa Rica;31/12/2018;30;16;14
Castilla y León;Cuba;31/12/2018;34;13;21
Castilla y León;Dominica;31/12/2018;0;0;0
Castilla y León;Ecuador;31/12/2018;170;78;92
Castilla y León;Egipto;31/12/2018;14;7;7
Castilla y León;El Salvador;31/12/2018;21;7;14
Castilla y León;Emiratos Árabes Unidos;31/12/2018;2;2;0
Castilla y León;Eritrea;31/12/2018;0;0;0
Castilla y León;Estados Unidos;31/12/2018;179;62;117
Castilla y León;Etiopía;31/12/2018;2;2;0
Castilla y León;Filipinas;31/12/2018;41;15;26
Castilla y León;Fiyi;31/12/2018;0;0;0
Castilla y León;Gabón;31/12/2018;4;2;2
Castilla y León;Gambia;31/12/2018;0;0;0
Castilla y León;Georgia;31/12/2018;12;6;6
Castilla y León;Ghana;31/12/2018;0;0;0
Castilla y León;Granada;31/12/2018;0;0;0
Castilla y León;Guatemala;31/12/2018;13;6;7
Castilla y León;Guinea;31/12/2018;1;1;0
Castilla y León;Guinea Bissau;31/12/2018;7;6;1
Castilla y León;Guinea Ecuatorial;31/12/2018;91;35;56
Castilla y León;Guyana;31/12/2018;0;0;0
Castilla y León;Haití;31/12/2018;10;8;2
Castilla y León;Honduras;31/12/2018;57;24;33
Castilla y León;India;31/12/2018;38;22;16
Castilla y León;Indonesia;31/12/2018;15;13;2
Castilla y León;Irak;31/12/2018;4;4;0
Castilla y León;Irán;31/12/2018;10;2;8
Castilla y León;Islas Salomón;31/12/2018;0;0;0
Castilla y León;Israel;31/12/2018;7;7;0
Castilla y León;Jamaica;31/12/2018;1;0;1
Castilla y León;Japón;31/12/2018;88;42;46
Castilla y León;Jordania;31/12/2018;32;6;26
Castilla y León;Kazajistán;31/12/2018;10;4;6
Castilla y León;Kenia;31/12/2018;0;0;0
Castilla y León;Kirguistán;31/12/2018;0;0;0
Castilla y León;Kuwait;31/12/2018;1;1;0
Castilla y León;Laos;31/12/2018;0;0;0
Castilla y León;Lesoto;31/12/2018;0;0;0
Castilla y León;Líbano;31/12/2018;12;4;8
Castilla y León;Liberia;31/12/2018;0;0;0
Castilla y León;Libia;31/12/2018;8;4;4
Castilla y León;Macedonia;31/12/2018;0;0;0
Castilla y León;Madagascar;31/12/2018;2;1;1
Castilla y León;Malasia;31/12/2018;4;3;1
Castilla y León;Malaui;31/12/2018;0;0;0
Castilla y León;Maldivas;31/12/2018;0;0;0
Castilla y León;Mali;31/12/2018;0;0;0
Castilla y León;Marruecos;31/12/2018;56;30;26
Castilla y León;Mauricio;31/12/2018;0;0;0
Castilla y León;Mauritania;31/12/2018;3;3;0
Castilla y León;México;31/12/2018;132;56;76
Castilla y León;Micronesia;31/12/2018;0;0;0
Castilla y León;Moldavia;31/12/2018;0;0;0
Castilla y León;Mónaco;31/12/2018;0;0;0
Castilla y León;Mongolia;31/12/2018;0;0;0
Castilla y León;Montenegro;31/12/2018;1;0;1
Castilla y León;Mozambique;31/12/2018;2;1;1
Castilla y León;Myanmar;31/12/2018;0;0;0
Castilla y León;Namibia;31/12/2018;0;0;0
Castilla y León;Nepal;31/12/2018;3;3;0
Castilla y León;Nicaragua;31/12/2018;10;4;6
Castilla y León;Níger;31/12/2018;2;2;0
Castilla y León;Nigeria;31/12/2018;3;3;0
Castilla y León;Nueva Zelanda;31/12/2018;3;1;2
Castilla y León;Oceanía (No consta país);31/12/2018;0;0;0
Castilla y León;Omán;31/12/2018;14;14;0
Castilla y León;Pakistán;31/12/2018;0;0;0
Castilla y León;Palestina;31/12/2018;1;0;1
Castilla y León;Panamá;31/12/2018;28;9;19
Castilla y León;Papúa Nueva Guinea;31/12/2018;0;0;0
Castilla y León;Paraguay;31/12/2018;10;5;5
Castilla y León;Perú;31/12/2018;116;49;67
Castilla y León;Qatar;31/12/2018;2;2;0
Castilla y León;Reino Unido;31/12/2018;0;0;0
Castilla y León;Rep. Centroafricana;31/12/2018;1;1;0
Castilla y León;Rep. Dem. del Congo;31/12/2018;8;7;1
Castilla y León;República Dominicana;31/12/2018;89;20;69
Castilla y León;Ruanda;31/12/2018;0;0;0
Castilla y León;Rusia;31/12/2018;27;9;18
Castilla y León;Samoa;31/12/2018;0;0;0
Castilla y León;San Cristóbal y Nieves;31/12/2018;0;0;0
Castilla y León;San Marino;31/12/2018;0;0;0
Castilla y León;San Vicente y Granadinas;31/12/2018;0;0;0
Castilla y León;Santa Lucía;31/12/2018;0;0;0
Castilla y León;Santo Tomé y Príncipe;31/12/2018;0;0;0
Castilla y León;Senegal;31/12/2018;4;0;4
Castilla y León;Serbia;31/12/2018;3;1;2
Castilla y León;Seychelles;31/12/2018;1;1;0
Castilla y León;Sierra Leona;31/12/2018;0;0;0
Castilla y León;Singapur;31/12/2018;3;1;2
Castilla y León;Siria;31/12/2018;1;1;0
Castilla y León;Somalia;31/12/2018;0;0;0
Castilla y León;Sri Lanka;31/12/2018;1;1;0
Castilla y León;Suazilandia;31/12/2018;0;0;0
Castilla y León;Sudáfrica;31/12/2018;2;1;1
Castilla y León;Sudán;31/12/2018;0;0;0
Castilla y León;Surinam;31/12/2018;0;0;0
Castilla y León;Tailandia;31/12/2018;5;2;3
Castilla y León;Taiwán;31/12/2018;67;21;46
Castilla y León;Tanzania;31/12/2018;10;5;5
Castilla y León;Tayikistán;31/12/2018;0;0;0
Castilla y León;Togo;31/12/2018;1;1;0
Castilla y León;Trinidad y Tobago;31/12/2018;0;0;0
Castilla y León;Túnez;31/12/2018;4;2;2
Castilla y León;Turkmenistán;31/12/2018;0;0;0
Castilla y León;Turquía;31/12/2018;26;11;15
Castilla y León;Ucrania;31/12/2018;16;12;4
Castilla y León;Uganda;31/12/2018;1;1;0
Castilla y León;Uruguay;31/12/2018;12;7;5
Castilla y León;Uzbekistán;31/12/2018;0;0;0
Castilla y León;Vanuatu;31/12/2018;0;0;0
Castilla y León;Venezuela;31/12/2018;74;35;39
Castilla y León;Vietnam;31/12/2018;24;9;15
Castilla y León;Yemen;31/12/2018;0;0;0
Castilla y León;Yibuti;31/12/2018;0;0;0
Castilla y León;Zambia;31/12/2018;0;0;0
Castilla y León;Zimbabue;31/12/2018;1;0;1
Castilla y León;Todas las nacionalidades;31/12/2017;3398;1434;1964
Castilla y León;Afganistán;31/12/2017;0;0;0
Castilla y León;Albania;31/12/2017;3;1;2
Castilla y León;Andorra;31/12/2017;2;1;1
Castilla y León;Angola;31/12/2017;8;6;2
Castilla y León;Antigua y Barbuda;31/12/2017;0;0;0
Castilla y León;Arabia Saudí;31/12/2017;1;0;1
Castilla y León;Argelia;31/12/2017;18;13;5
Castilla y León;Argentina;31/12/2017;33;14;19
Castilla y León;Armenia;31/12/2017;1;1;0
Castilla y León;Australia;31/12/2017;11;6;5
Castilla y León;Azerbaiyán;31/12/2017;1;1;0
Castilla y León;Bahamas;31/12/2017;1;0;1
Castilla y León;Bahrein;31/12/2017;0;0;0
Castilla y León;Bangladés;31/12/2017;1;1;0
Castilla y León;Barbados;31/12/2017;0;0;0
Castilla y León;Belice;31/12/2017;0;0;0
Castilla y León;Benín;31/12/2017;3;3;0
Castilla y León;Bielorrusia;31/12/2017;1;0;1
Castilla y León;Bolivia;31/12/2017;70;28;42
Castilla y León;Bosnia-Herzegovina;31/12/2017;2;1;1
Castilla y León;Botsuana;31/12/2017;0;0;0
Castilla y León;Brasil;31/12/2017;155;77;78
Castilla y León;Brunei;31/12/2017;0;0;0
Castilla y León;Burkina Faso;31/12/2017;0;0;0
Castilla y León;Burundi;31/12/2017;4;4;0
Castilla y León;Bután;31/12/2017;0;0;0
Castilla y León;Cabo Verde;31/12/2017;1;0;1
Castilla y León;Camboya;31/12/2017;0;0;0
Castilla y León;Camerún;31/12/2017;3;3;0
Castilla y León;Canadá;31/12/2017;7;4;3
Castilla y León;Chad;31/12/2017;0;0;0
Castilla y León;Chile;31/12/2017;59;35;24
Castilla y León;China;31/12/2017;1276;484;792
Castilla y León;Colombia;31/12/2017;190;90;100
Castilla y León;Comores;31/12/2017;0;0;0
Castilla y León;Congo;31/12/2017;2;2;0
Castilla y León;Corea del Norte;31/12/2017;0;0;0
Castilla y León;Corea del Sur;31/12/2017;52;23;29
Castilla y León;Costa de Marfil;31/12/2017;5;5;0
Castilla y León;Costa Rica;31/12/2017;25;11;14
Castilla y León;Cuba;31/12/2017;28;12;16
Castilla y León;Dominica;31/12/2017;2;0;2
Castilla y León;Ecuador;31/12/2017;145;65;80
Castilla y León;Egipto;31/12/2017;11;2;9
Castilla y León;El Salvador;31/12/2017;26;9;17
Castilla y León;Emiratos Árabes Unidos;31/12/2017;0;0;0
Castilla y León;Eritrea;31/12/2017;0;0;0
Castilla y León;Estados Unidos;31/12/2017;176;56;120
Castilla y León;Etiopía;31/12/2017;0;0;0
Castilla y León;Filipinas;31/12/2017;24;6;18
Castilla y León;Fiyi;31/12/2017;0;0;0
Castilla y León;Gabón;31/12/2017;5;3;2
Castilla y León;Gambia;31/12/2017;0;0;0
Castilla y León;Georgia;31/12/2017;11;7;4
Castilla y León;Ghana;31/12/2017;0;0;0
Castilla y León;Granada;31/12/2017;0;0;0
Castilla y León;Guatemala;31/12/2017;13;5;8
Castilla y León;Guinea;31/12/2017;0;0;0
Castilla y León;Guinea Bissau;31/12/2017;0;0;0
Castilla y León;Guinea Ecuatorial;31/12/2017;78;36;42
Castilla y León;Guyana;31/12/2017;1;0;1
Castilla y León;Haití;31/12/2017;7;6;1
Castilla y León;Honduras;31/12/2017;58;30;28
Castilla y León;India;31/12/2017;31;14;17
Castilla y León;Indonesia;31/12/2017;14;9;5
Castilla y León;Irak;31/12/2017;3;2;1
Castilla y León;Irán;31/12/2017;9;1;8
Castilla y León;Islas Salomón;31/12/2017;0;0;0
Castilla y León;Israel;31/12/2017;5;5;0
Castilla y León;Jamaica;31/12/2017;1;0;1
Castilla y León;Japón;31/12/2017;82;33;49
Castilla y León;Jordania;31/12/2017;28;6;22
Castilla y León;Kazajistán;31/12/2017;6;0;6
Castilla y León;Kenia;31/12/2017;0;0;0
Castilla y León;Kirguistán;31/12/2017;0;0;0
Castilla y León;Kuwait;31/12/2017;1;1;0
Castilla y León;Laos;31/12/2017;0;0;0
Castilla y León;Lesoto;31/12/2017;0;0;0
Castilla y León;Líbano;31/12/2017;6;3;3
Castilla y León;Liberia;31/12/2017;0;0;0
Castilla y León;Libia;31/12/2017;11;7;4
Castilla y León;Macedonia;31/12/2017;0;0;0
Castilla y León;Madagascar;31/12/2017;2;1;1
Castilla y León;Malasia;31/12/2017;3;1;2
Castilla y León;Malaui;31/12/2017;1;1;0
Castilla y León;Maldivas;31/12/2017;0;0;0
Castilla y León;Mali;31/12/2017;0;0;0
Castilla y León;Marruecos;31/12/2017;48;23;25
Castilla y León;Mauricio;31/12/2017;0;0;0
Castilla y León;Mauritania;31/12/2017;2;2;0
Castilla y León;México;31/12/2017;119;48;71
Castilla y León;Micronesia;31/12/2017;0;0;0
Castilla y León;Moldavia;31/12/2017;0;0;0
Castilla y León;Mónaco;31/12/2017;1;0;1
Castilla y León;Mongolia;31/12/2017;0;0;0
Castilla y León;Montenegro;31/12/2017;0;0;0
Castilla y León;Mozambique;31/12/2017;1;0;1
Castilla y León;Myanmar;31/12/2017;0;0;0
Castilla y León;Namibia;31/12/2017;0;0;0
Castilla y León;Nepal;31/12/2017;2;1;1
Castilla y León;Nicaragua;31/12/2017;11;5;6
Castilla y León;Níger;31/12/2017;9;9;0
Castilla y León;Nigeria;31/12/2017;5;4;1
Castilla y León;Nueva Zelanda;31/12/2017;2;2;0
Castilla y León;Oceanía (No consta país);31/12/2017;0;0;0
Castilla y León;Omán;31/12/2017;3;3;0
Castilla y León;Pakistán;31/12/2017;1;1;0
Castilla y León;Palestina;31/12/2017;0;0;0
Castilla y León;Panamá;31/12/2017;30;10;20
Castilla y León;Papúa Nueva Guinea;31/12/2017;0;0;0
Castilla y León;Paraguay;31/12/2017;9;3;6
Castilla y León;Perú;31/12/2017;123;60;63
Castilla y León;Qatar;31/12/2017;0;0;0
Castilla y León;Reino Unido;31/12/2017;0;0;0
Castilla y León;Rep. Centroafricana;31/12/2017;0;0;0
Castilla y León;Rep. Dem. del Congo;31/12/2017;4;4;0
Castilla y León;República Dominicana;31/12/2017;50;16;34
Castilla y León;Ruanda;31/12/2017;0;0;0
Castilla y León;Rusia;31/12/2017;31;8;23
Castilla y León;Samoa;31/12/2017;0;0;0
Castilla y León;San Cristóbal y Nieves;31/12/2017;0;0;0
Castilla y León;San Marino;31/12/2017;0;0;0
Castilla y León;San Vicente y Granadinas;31/12/2017;0;0;0
Castilla y León;Santa Lucía;31/12/2017;0;0;0
Castilla y León;Santo Tomé y Príncipe;31/12/2017;0;0;0
Castilla y León;Senegal;31/12/2017;1;0;1
Castilla y León;Serbia;31/12/2017;3;1;2
Castilla y León;Seychelles;31/12/2017;1;1;0
Castilla y León;Sierra Leona;31/12/2017;0;0;0
Castilla y León;Singapur;31/12/2017;3;2;1
Castilla y León;Siria;31/12/2017;5;3;2
Castilla y León;Somalia;31/12/2017;0;0;0
Castilla y León;Sri Lanka;31/12/2017;0;0;0
Castilla y León;Suazilandia;31/12/2017;0;0;0
Castilla y León;Sudáfrica;31/12/2017;1;0;1
Castilla y León;Sudán;31/12/2017;0;0;0
Castilla y León;Surinam;31/12/2017;0;0;0
Castilla y León;Tailandia;31/12/2017;6;2;4
Castilla y León;Taiwán;31/12/2017;50;17;33
Castilla y León;Tanzania;31/12/2017;7;3;4
Castilla y León;Tayikistán;31/12/2017;0;0;0
Castilla y León;Togo;31/12/2017;1;1;0
Castilla y León;Trinidad y Tobago;31/12/2017;0;0;0
Castilla y León;Túnez;31/12/2017;1;0;1
Castilla y León;Turkmenistán;31/12/2017;0;0;0
Castilla y León;Turquía;31/12/2017;25;14;11
Castilla y León;Ucrania;31/12/2017;26;14;12
Castilla y León;Uganda;31/12/2017;0;0;0
Castilla y León;Uruguay;31/12/2017;8;4;4
Castilla y León;Uzbekistán;31/12/2017;0;0;0
Castilla y León;Vanuatu;31/12/2017;0;0;0
Castilla y León;Venezuela;31/12/2017;67;32;35
Castilla y León;Vietnam;31/12/2017;17;5;12
Castilla y León;Yemen;31/12/2017;0;0;0
Castilla y León;Yibuti;31/12/2017;0;0;0
Castilla y León;Zambia;31/12/2017;0;0;0
Castilla y León;Zimbabue;31/12/2017;1;0;1
Castilla y León;Todas las nacionalidades;31/12/2016;3205;1294;1911
Castilla y León;Afganistán;31/12/2016;0;0;0
Castilla y León;Albania;31/12/2016;5;1;4
Castilla y León;Andorra;31/12/2016;2;1;1
Castilla y León;Angola;31/12/2016;9;7;2
Castilla y León;Antigua y Barbuda;31/12/2016;0;0;0
Castilla y León;Arabia Saudí;31/12/2016;5;3;2
Castilla y León;Argelia;31/12/2016;12;7;5
Castilla y León;Argentina;31/12/2016;42;18;24
Castilla y León;Armenia;31/12/2016;0;0;0
Castilla y León;Australia;31/12/2016;10;5;5
Castilla y León;Azerbaiyán;31/12/2016;1;1;0
Castilla y León;Bahamas;31/12/2016;1;0;1
Castilla y León;Bahrein;31/12/2016;0;0;0
Castilla y León;Bangladés;31/12/2016;3;3;0
Castilla y León;Barbados;31/12/2016;0;0;0
Castilla y León;Belice;31/12/2016;0;0;0
Castilla y León;Benín;31/12/2016;2;2;0
Castilla y León;Bielorrusia;31/12/2016;2;1;1
Castilla y León;Bolivia;31/12/2016;60;29;31
Castilla y León;Bosnia-Herzegovina;31/12/2016;1;0;1
Castilla y León;Botsuana;31/12/2016;0;0;0
Castilla y León;Brasil;31/12/2016;169;86;83
Castilla y León;Brunei;31/12/2016;0;0;0
Castilla y León;Burkina Faso;31/12/2016;2;2;0
Castilla y León;Burundi;31/12/2016;4;4;0
Castilla y León;Bután;31/12/2016;0;0;0
Castilla y León;Cabo Verde;31/12/2016;0;0;0
Castilla y León;Camboya;31/12/2016;0;0;0
Castilla y León;Camerún;31/12/2016;2;2;0
Castilla y León;Canadá;31/12/2016;14;5;9
Castilla y León;Chad;31/12/2016;1;1;0
Castilla y León;Chile;31/12/2016;36;22;14
Castilla y León;China;31/12/2016;1093;370;723
Castilla y León;Colombia;31/12/2016;185;74;111
Castilla y León;Comores;31/12/2016;0;0;0
Castilla y León;Congo;31/12/2016;3;2;1
Castilla y León;Corea del Norte;31/12/2016;0;0;0
Castilla y León;Corea del Sur;31/12/2016;64;26;38
Castilla y León;Costa de Marfil;31/12/2016;7;7;0
Castilla y León;Costa Rica;31/12/2016;19;7;12
Castilla y León;Cuba;31/12/2016;16;8;8
Castilla y León;Dominica;31/12/2016;0;0;0
Castilla y León;Ecuador;31/12/2016;129;65;64
Castilla y León;Egipto;31/12/2016;6;3;3
Castilla y León;El Salvador;31/12/2016;21;10;11
Castilla y León;Emiratos Árabes Unidos;31/12/2016;0;0;0
Castilla y León;Eritrea;31/12/2016;0;0;0
Castilla y León;Estados Unidos;31/12/2016;200;64;136
Castilla y León;Etiopía;31/12/2016;1;1;0
Castilla y León;Filipinas;31/12/2016;13;5;8
Castilla y León;Fiyi;31/12/2016;0;0;0
Castilla y León;Gabón;31/12/2016;7;5;2
Castilla y León;Gambia;31/12/2016;0;0;0
Castilla y León;Georgia;31/12/2016;6;2;4
Castilla y León;Ghana;31/12/2016;0;0;0
Castilla y León;Granada;31/12/2016;0;0;0
Castilla y León;Guatemala;31/12/2016;25;13;12
Castilla y León;Guinea;31/12/2016;0;0;0
Castilla y León;Guinea Bissau;31/12/2016;0;0;0
Castilla y León;Guinea Ecuatorial;31/12/2016;70;27;43
Castilla y León;Guyana;31/12/2016;0;0;0
Castilla y León;Haití;31/12/2016;4;3;1
Castilla y León;Honduras;31/12/2016;38;18;20
Castilla y León;India;31/12/2016;32;16;16
Castilla y León;Indonesia;31/12/2016;11;8;3
Castilla y León;Irak;31/12/2016;4;3;1
Castilla y León;Irán;31/12/2016;4;2;2
Castilla y León;Islas Salomón;31/12/2016;0;0;0
Castilla y León;Israel;31/12/2016;5;4;1
Castilla y León;Jamaica;31/12/2016;0;0;0
Castilla y León;Japón;31/12/2016;87;32;55
Castilla y León;Jordania;31/12/2016;20;4;16
Castilla y León;Kazajistán;31/12/2016;7;1;6
Castilla y León;Kenia;31/12/2016;1;0;1
Castilla y León;Kirguistán;31/12/2016;0;0;0
Castilla y León;Kuwait;31/12/2016;0;0;0
Castilla y León;Laos;31/12/2016;0;0;0
Castilla y León;Lesoto;31/12/2016;0;0;0
Castilla y León;Líbano;31/12/2016;5;4;1
Castilla y León;Liberia;31/12/2016;0;0;0
Castilla y León;Libia;31/12/2016;15;9;6
Castilla y León;Macedonia;31/12/2016;0;0;0
Castilla y León;Madagascar;31/12/2016;4;3;1
Castilla y León;Malasia;31/12/2016;2;1;1
Castilla y León;Malaui;31/12/2016;0;0;0
Castilla y León;Maldivas;31/12/2016;0;0;0
Castilla y León;Mali;31/12/2016;0;0;0
Castilla y León;Marruecos;31/12/2016;45;25;20
Castilla y León;Mauricio;31/12/2016;0;0;0
Castilla y León;Mauritania;31/12/2016;1;1;0
Castilla y León;México;31/12/2016;111;50;61
Castilla y León;Micronesia;31/12/2016;0;0;0
Castilla y León;Moldavia;31/12/2016;1;0;1
Castilla y León;Mónaco;31/12/2016;1;0;1
Castilla y León;Mongolia;31/12/2016;0;0;0
Castilla y León;Montenegro;31/12/2016;1;0;1
Castilla y León;Mozambique;31/12/2016;1;0;1
Castilla y León;Myanmar;31/12/2016;0;0;0
Castilla y León;Namibia;31/12/2016;0;0;0
Castilla y León;Nepal;31/12/2016;3;0;3
Castilla y León;Nicaragua;31/12/2016;18;9;9
Castilla y León;Níger;31/12/2016;5;5;0
Castilla y León;Nigeria;31/12/2016;3;3;0
Castilla y León;Nueva Zelanda;31/12/2016;1;1;0
Castilla y León;Oceanía (No consta país);31/12/2016;0;0;0
Castilla y León;Omán;31/12/2016;0;0;0
Castilla y León;Pakistán;31/12/2016;1;1;0
Castilla y León;Palestina;31/12/2016;0;0;0
Castilla y León;Panamá;31/12/2016;28;11;17
Castilla y León;Papúa Nueva Guinea;31/12/2016;0;0;0
Castilla y León;Paraguay;31/12/2016;10;2;8
Castilla y León;Perú;31/12/2016;102;53;49
Castilla y León;Qatar;31/12/2016;2;2;0
Castilla y León;Reino Unido;31/12/2016;0;0;0
Castilla y León;Rep. Centroafricana;31/12/2016;0;0;0
Castilla y León;Rep. Dem. del Congo;31/12/2016;2;2;0
Castilla y León;República Dominicana;31/12/2016;97;31;66
Castilla y León;Ruanda;31/12/2016;0;0;0
Castilla y León;Rusia;31/12/2016;42;9;33
Castilla y León;Samoa;31/12/2016;0;0;0
Castilla y León;San Cristóbal y Nieves;31/12/2016;0;0;0
Castilla y León;San Marino;31/12/2016;0;0;0
Castilla y León;San Vicente y Granadinas;31/12/2016;0;0;0
Castilla y León;Santa Lucía;31/12/2016;1;0;1
Castilla y León;Santo Tomé y Príncipe;31/12/2016;0;0;0
Castilla y León;Senegal;31/12/2016;4;0;4
Castilla y León;Serbia;31/12/2016;3;2;1
Castilla y León;Seychelles;31/12/2016;0;0;0
Castilla y León;Sierra Leona;31/12/2016;0;0;0
Castilla y León;Singapur;31/12/2016;2;2;0
Castilla y León;Siria;31/12/2016;5;3;2
Castilla y León;Somalia;31/12/2016;0;0;0
Castilla y León;Sri Lanka;31/12/2016;0;0;0
Castilla y León;Suazilandia;31/12/2016;0;0;0
Castilla y León;Sudáfrica;31/12/2016;5;0;5
Castilla y León;Sudán;31/12/2016;0;0;0
Castilla y León;Surinam;31/12/2016;0;0;0
Castilla y León;Tailandia;31/12/2016;5;2;3
Castilla y León;Taiwán;31/12/2016;53;9;44
Castilla y León;Tanzania;31/12/2016;10;4;6
Castilla y León;Tayikistán;31/12/2016;0;0;0
Castilla y León;Togo;31/12/2016;3;3;0
Castilla y León;Trinidad y Tobago;31/12/2016;0;0;0
Castilla y León;Túnez;31/12/2016;5;2;3
Castilla y León;Turkmenistán;31/12/2016;0;0;0
Castilla y León;Turquía;31/12/2016;21;12;9
Castilla y León;Ucrania;31/12/2016;29;11;18
Castilla y León;Uganda;31/12/2016;0;0;0
Castilla y León;Uruguay;31/12/2016;3;2;1
Castilla y León;Uzbekistán;31/12/2016;0;0;0
Castilla y León;Vanuatu;31/12/2016;0;0;0
Castilla y León;Venezuela;31/12/2016;81;34;47
Castilla y León;Vietnam;31/12/2016;10;4;6
Castilla y León;Yemen;31/12/2016;0;0;0
Castilla y León;Yibuti;31/12/2016;0;0;0
Castilla y León;Zambia;31/12/2016;0;0;0
Castilla y León;Zimbabue;31/12/2016;3;2;1
Castilla y León;Todas las nacionalidades;31/12/2015;1742;799;943
Castilla y León;Afganistán;31/12/2015;0;0;0
Castilla y León;Albania;31/12/2015;0;0;0
Castilla y León;Andorra;31/12/2015;0;0;0
Castilla y León;Angola;31/12/2015;7;5;2
Castilla y León;Antigua y Barbuda;31/12/2015;0;0;0
Castilla y León;Arabia Saudí;31/12/2015;14;10;4
Castilla y León;Argelia;31/12/2015;14;6;8
Castilla y León;Argentina;31/12/2015;25;13;12
Castilla y León;Armenia;31/12/2015;0;0;0
Castilla y León;Australia;31/12/2015;2;1;1
Castilla y León;Azerbaiyán;31/12/2015;2;1;1
Castilla y León;Bahamas;31/12/2015;1;0;1
Castilla y León;Bahrein;31/12/2015;0;0;0
Castilla y León;Bangladés;31/12/2015;0;0;0
Castilla y León;Barbados;31/12/2015;0;0;0
Castilla y León;Belice;31/12/2015;0;0;0
Castilla y León;Benín;31/12/2015;4;4;0
Castilla y León;Bielorrusia;31/12/2015;0;0;0
Castilla y León;Bolivia;31/12/2015;26;11;15
Castilla y León;Bosnia-Herzegovina;31/12/2015;1;0;1
Castilla y León;Botsuana;31/12/2015;0;0;0
Castilla y León;Brasil;31/12/2015;139;72;67
Castilla y León;Brunei;31/12/2015;0;0;0
Castilla y León;Burkina Faso;31/12/2015;3;3;0
Castilla y León;Burundi;31/12/2015;4;4;0
Castilla y León;Bután;31/12/2015;0;0;0
Castilla y León;Cabo Verde;31/12/2015;2;1;1
Castilla y León;Camboya;31/12/2015;0;0;0
Castilla y León;Camerún;31/12/2015;1;1;0
Castilla y León;Canadá;31/12/2015;6;0;6
Castilla y León;Chad;31/12/2015;1;1;0
Castilla y León;Chile;31/12/2015;31;18;13
Castilla y León;China;31/12/2015;483;175;308
Castilla y León;Colombia;31/12/2015;117;53;64
Castilla y León;Comores;31/12/2015;0;0;0
Castilla y León;Congo;31/12/2015;0;0;0
Castilla y León;Corea del Norte;31/12/2015;0;0;0
Castilla y León;Corea del Sur;31/12/2015;41;17;24
Castilla y León;Costa de Marfil;31/12/2015;9;9;0
Castilla y León;Costa Rica;31/12/2015;10;5;5
Castilla y León;Cuba;31/12/2015;5;3;2
Castilla y León;Dominica;31/12/2015;1;0;1
Castilla y León;Ecuador;31/12/2015;59;26;33
Castilla y León;Egipto;31/12/2015;8;4;4
Castilla y León;El Salvador;31/12/2015;16;8;8
Castilla y León;Emiratos Árabes Unidos;31/12/2015;0;0;0
Castilla y León;Eritrea;31/12/2015;0;0;0
Castilla y León;Estados Unidos;31/12/2015;105;37;68
Castilla y León;Etiopía;31/12/2015;2;1;1
Castilla y León;Filipinas;31/12/2015;11;7;4
Castilla y León;Fiyi;31/12/2015;0;0;0
Castilla y León;Gabón;31/12/2015;8;6;2
Castilla y León;Gambia;31/12/2015;0;0;0
Castilla y León;Georgia;31/12/2015;6;3;3
Castilla y León;Ghana;31/12/2015;0;0;0
Castilla y León;Granada;31/12/2015;0;0;0
Castilla y León;Guatemala;31/12/2015;14;8;6
Castilla y León;Guinea;31/12/2015;0;0;0
Castilla y León;Guinea Bissau;31/12/2015;1;0;1
Castilla y León;Guinea Ecuatorial;31/12/2015;60;30;30
Castilla y León;Guyana;31/12/2015;0;0;0
Castilla y León;Haití;31/12/2015;3;2;1
Castilla y León;Honduras;31/12/2015;19;13;6
Castilla y León;India;31/12/2015;16;10;6
Castilla y León;Indonesia;31/12/2015;2;2;0
Castilla y León;Irak;31/12/2015;1;1;0
Castilla y León;Irán;31/12/2015;6;0;6
Castilla y León;Islas Salomón;31/12/2015;0;0;0
Castilla y León;Israel;31/12/2015;1;0;1
Castilla y León;Jamaica;31/12/2015;0;0;0
Castilla y León;Japón;31/12/2015;19;8;11
Castilla y León;Jordania;31/12/2015;4;0;4
Castilla y León;Kazajistán;31/12/2015;3;0;3
Castilla y León;Kenia;31/12/2015;1;0;1
Castilla y León;Kirguistán;31/12/2015;0;0;0
Castilla y León;Kuwait;31/12/2015;0;0;0
Castilla y León;Laos;31/12/2015;1;0;1
Castilla y León;Lesoto;31/12/2015;0;0;0
Castilla y León;Líbano;31/12/2015;5;4;1
Castilla y León;Liberia;31/12/2015;0;0;0
Castilla y León;Libia;31/12/2015;6;5;1
Castilla y León;Macedonia;31/12/2015;0;0;0
Castilla y León;Madagascar;31/12/2015;1;1;0
Castilla y León;Malasia;31/12/2015;7;4;3
Castilla y León;Malaui;31/12/2015;0;0;0
Castilla y León;Maldivas;31/12/2015;0;0;0
Castilla y León;Mali;31/12/2015;0;0;0
Castilla y León;Marruecos;31/12/2015;62;35;27
Castilla y León;Mauricio;31/12/2015;0;0;0
Castilla y León;Mauritania;31/12/2015;2;2;0
Castilla y León;México;31/12/2015;57;27;30
Castilla y León;Micronesia;31/12/2015;0;0;0
Castilla y León;Moldavia;31/12/2015;0;0;0
Castilla y León;Mónaco;31/12/2015;0;0;0
Castilla y León;Mongolia;31/12/2015;0;0;0
Castilla y León;Montenegro;31/12/2015;0;0;0
Castilla y León;Mozambique;31/12/2015;1;1;0
Castilla y León;Myanmar;31/12/2015;0;0;0
Castilla y León;Namibia;31/12/2015;0;0;0
Castilla y León;Nepal;31/12/2015;2;1;1
Castilla y León;Nicaragua;31/12/2015;8;6;2
Castilla y León;Níger;31/12/2015;1;1;0
Castilla y León;Nigeria;31/12/2015;3;3;0
Castilla y León;Nueva Zelanda;31/12/2015;2;1;1
Castilla y León;Oceanía (No consta país);31/12/2015;0;0;0
Castilla y León;Omán;31/12/2015;1;1;0
Castilla y León;Pakistán;31/12/2015;1;1;0
Castilla y León;Palestina;31/12/2015;0;0;0
Castilla y León;Panamá;31/12/2015;8;4;4
Castilla y León;Papúa Nueva Guinea;31/12/2015;0;0;0
Castilla y León;Paraguay;31/12/2015;6;3;3
Castilla y León;Perú;31/12/2015;74;44;30
Castilla y León;Qatar;31/12/2015;2;2;0
Castilla y León;Reino Unido;31/12/2015;0;0;0
Castilla y León;Rep. Centroafricana;31/12/2015;0;0;0
Castilla y León;Rep. Dem. del Congo;31/12/2015;2;2;0
Castilla y León;República Dominicana;31/12/2015;35;15;20
Castilla y León;Ruanda;31/12/2015;1;1;0
Castilla y León;Rusia;31/12/2015;20;6;14
Castilla y León;Samoa;31/12/2015;0;0;0
Castilla y León;San Cristóbal y Nieves;31/12/2015;0;0;0
Castilla y León;San Marino;31/12/2015;0;0;0
Castilla y León;San Vicente y Granadinas;31/12/2015;0;0;0
Castilla y León;Santa Lucía;31/12/2015;0;0;0
Castilla y León;Santo Tomé y Príncipe;31/12/2015;0;0;0
Castilla y León;Senegal;31/12/2015;5;1;4
Castilla y León;Serbia;31/12/2015;1;0;1
Castilla y León;Seychelles;31/12/2015;0;0;0
Castilla y León;Sierra Leona;31/12/2015;0;0;0
Castilla y León;Singapur;31/12/2015;0;0;0
Castilla y León;Siria;31/12/2015;3;2;1
Castilla y León;Somalia;31/12/2015;0;0;0
Castilla y León;Sri Lanka;31/12/2015;0;0;0
Castilla y León;Suazilandia;31/12/2015;0;0;0
Castilla y León;Sudáfrica;31/12/2015;3;1;2
Castilla y León;Sudán;31/12/2015;1;1;0
Castilla y León;Surinam;31/12/2015;0;0;0
Castilla y León;Tailandia;31/12/2015;7;4;3
Castilla y León;Taiwán;31/12/2015;8;2;6
Castilla y León;Tanzania;31/12/2015;7;4;3
Castilla y León;Tayikistán;31/12/2015;0;0;0
Castilla y León;Togo;31/12/2015;0;0;0
Castilla y León;Trinidad y Tobago;31/12/2015;0;0;0
Castilla y León;Túnez;31/12/2015;1;0;1
Castilla y León;Turkmenistán;31/12/2015;0;0;0
Castilla y León;Turquía;31/12/2015;3;2;1
Castilla y León;Ucrania;31/12/2015;18;5;13
Castilla y León;Uganda;31/12/2015;0;0;0
Castilla y León;Uruguay;31/12/2015;2;1;1
Castilla y León;Uzbekistán;31/12/2015;0;0;0
Castilla y León;Vanuatu;31/12/2015;0;0;0
Castilla y León;Venezuela;31/12/2015;55;23;32
Castilla y León;Vietnam;31/12/2015;3;2;1
Castilla y León;Yemen;31/12/2015;0;0;0
Castilla y León;Yibuti;31/12/2015;1;1;0
Castilla y León;Zambia;31/12/2015;0;0;0
Castilla y León;Zimbabue;31/12/2015;2;1;1
Salamanca;Todas las nacionalidades;31/12/2021;1430;572;858
Salamanca;Afganistán;31/12/2021;0;0;0
Salamanca;Albania;31/12/2021;1;0;1
Salamanca;Andorra;31/12/2021;0;0;0
Salamanca;Angola;31/12/2021;1;1;0
Salamanca;Antigua y Barbuda;31/12/2021;0;0;0
Salamanca;Arabia Saudí;31/12/2021;1;1;0
Salamanca;Argelia;31/12/2021;27;6;21
Salamanca;Argentina;31/12/2021;26;12;14
Salamanca;Armenia;31/12/2021;0;0;0
Salamanca;Australia;31/12/2021;1;0;1
Salamanca;Azerbaiyán;31/12/2021;0;0;0
Salamanca;Bahamas;31/12/2021;0;0;0
Salamanca;Bahrein;31/12/2021;0;0;0
Salamanca;Bangladés;31/12/2021;0;0;0
Salamanca;Barbados;31/12/2021;0;0;0
Salamanca;Belice;31/12/2021;0;0;0
Salamanca;Benín;31/12/2021;1;1;0
Salamanca;Bielorrusia;31/12/2021;1;0;1
Salamanca;Bolivia;31/12/2021;8;4;4
Salamanca;Bosnia-Herzegovina;31/12/2021;0;0;0
Salamanca;Botsuana;31/12/2021;0;0;0
Salamanca;Brasil;31/12/2021;74;34;40
Salamanca;Brunei;31/12/2021;0;0;0
Salamanca;Burkina Faso;31/12/2021;0;0;0
Salamanca;Burundi;31/12/2021;0;0;0
Salamanca;Bután;31/12/2021;0;0;0
Salamanca;Cabo Verde;31/12/2021;0;0;0
Salamanca;Camboya;31/12/2021;0;0;0
Salamanca;Camerún;31/12/2021;4;2;2
Salamanca;Canadá;31/12/2021;2;0;2
Salamanca;Chad;31/12/2021;0;0;0
Salamanca;Chile;31/12/2021;39;21;18
Salamanca;China;31/12/2021;445;149;296
Salamanca;Colombia;31/12/2021;147;64;83
Salamanca;Comores;31/12/2021;0;0;0
Salamanca;Congo;31/12/2021;0;0;0
Salamanca;Corea del Norte;31/12/2021;0;0;0
Salamanca;Corea del Sur;31/12/2021;4;1;3
Salamanca;Costa de Marfil;31/12/2021;1;0;1
Salamanca;Costa Rica;31/12/2021;12;5;7
Salamanca;Cuba;31/12/2021;24;7;17
Salamanca;Dominica;31/12/2021;0;0;0
Salamanca;Ecuador;31/12/2021;70;32;38
Salamanca;Egipto;31/12/2021;6;5;1
Salamanca;El Salvador;31/12/2021;14;8;6
Salamanca;Emiratos Árabes Unidos;31/12/2021;0;0;0
Salamanca;Eritrea;31/12/2021;0;0;0
Salamanca;Estados Unidos;31/12/2021;44;20;24
Salamanca;Etiopía;31/12/2021;0;0;0
Salamanca;Filipinas;31/12/2021;0;0;0
Salamanca;Fiyi;31/12/2021;0;0;0
Salamanca;Gabón;31/12/2021;2;1;1
Salamanca;Gambia;31/12/2021;0;0;0
Salamanca;Georgia;31/12/2021;0;0;0
Salamanca;Ghana;31/12/2021;0;0;0
Salamanca;Granada;31/12/2021;0;0;0
Salamanca;Guatemala;31/12/2021;14;7;7
Salamanca;Guinea;31/12/2021;0;0;0
Salamanca;Guinea Bissau;31/12/2021;0;0;0
Salamanca;Guinea Ecuatorial;31/12/2021;40;15;25
Salamanca;Guyana;31/12/2021;0;0;0
Salamanca;Haití;31/12/2021;2;1;1
Salamanca;Honduras;31/12/2021;23;15;8
Salamanca;India;31/12/2021;6;2;4
Salamanca;Indonesia;31/12/2021;2;1;1
Salamanca;Irak;31/12/2021;0;0;0
Salamanca;Irán;31/12/2021;14;7;7
Salamanca;Islas Salomón;31/12/2021;0;0;0
Salamanca;Israel;31/12/2021;1;1;0
Salamanca;Jamaica;31/12/2021;0;0;0
Salamanca;Japón;31/12/2021;30;8;22
Salamanca;Jordania;31/12/2021;0;0;0
Salamanca;Kazajistán;31/12/2021;4;1;3
Salamanca;Kenia;31/12/2021;0;0;0
Salamanca;Kirguistán;31/12/2021;0;0;0
Salamanca;Kuwait;31/12/2021;0;0;0
Salamanca;Laos;31/12/2021;0;0;0
Salamanca;Lesoto;31/12/2021;0;0;0
Salamanca;Líbano;31/12/2021;1;1;0
Salamanca;Liberia;31/12/2021;0;0;0
Salamanca;Libia;31/12/2021;1;0;1
Salamanca;Macedonia;31/12/2021;0;0;0
Salamanca;Madagascar;31/12/2021;0;0;0
Salamanca;Malasia;31/12/2021;1;0;1
Salamanca;Malaui;31/12/2021;0;0;0
Salamanca;Maldivas;31/12/2021;0;0;0
Salamanca;Mali;31/12/2021;0;0;0
Salamanca;Marruecos;31/12/2021;68;26;42
Salamanca;Mauricio;31/12/2021;0;0;0
Salamanca;Mauritania;31/12/2021;0;0;0
Salamanca;México;31/12/2021;73;29;44
Salamanca;Micronesia;31/12/2021;0;0;0
Salamanca;Moldavia;31/12/2021;0;0;0
Salamanca;Mónaco;31/12/2021;0;0;0
Salamanca;Mongolia;31/12/2021;0;0;0
Salamanca;Montenegro;31/12/2021;0;0;0
Salamanca;Mozambique;31/12/2021;2;2;0
Salamanca;Myanmar;31/12/2021;0;0;0
Salamanca;Namibia;31/12/2021;0;0;0
Salamanca;Nepal;31/12/2021;0;0;0
Salamanca;Nicaragua;31/12/2021;3;1;2
Salamanca;Níger;31/12/2021;0;0;0
Salamanca;Nigeria;31/12/2021;0;0;0
Salamanca;Nueva Zelanda;31/12/2021;0;0;0
Salamanca;Oceanía (No consta país);31/12/2021;0;0;0
Salamanca;Omán;31/12/2021;0;0;0
Salamanca;Pakistán;31/12/2021;2;2;0
Salamanca;Palestina;31/12/2021;0;0;0
Salamanca;Panamá;31/12/2021;20;9;11
Salamanca;Papúa Nueva Guinea;31/12/2021;0;0;0
Salamanca;Paraguay;31/12/2021;4;1;3
Salamanca;Perú;31/12/2021;69;30;39
Salamanca;Qatar;31/12/2021;0;0;0
Salamanca;Reino Unido;31/12/2021;17;5;12
Salamanca;Rep. Centroafricana;31/12/2021;0;0;0
Salamanca;Rep. Dem. del Congo;31/12/2021;0;0;0
Salamanca;República Dominicana;31/12/2021;20;9;11
Salamanca;Ruanda;31/12/2021;0;0;0
Salamanca;Rusia;31/12/2021;14;2;12
Salamanca;Samoa;31/12/2021;0;0;0
Salamanca;San Cristóbal y Nieves;31/12/2021;0;0;0
Salamanca;San Marino;31/12/2021;0;0;0
Salamanca;San Vicente y Granadinas;31/12/2021;0;0;0
Salamanca;Santa Lucía;31/12/2021;0;0;0
Salamanca;Santo Tomé y Príncipe;31/12/2021;0;0;0
Salamanca;Senegal;31/12/2021;2;2;0
Salamanca;Serbia;31/12/2021;0;0;0
Salamanca;Seychelles;31/12/2021;0;0;0
Salamanca;Sierra Leona;31/12/2021;0;0;0
Salamanca;Singapur;31/12/2021;0;0;0
Salamanca;Siria;31/12/2021;0;0;0
Salamanca;Somalia;31/12/2021;0;0;0
Salamanca;Sri Lanka;31/12/2021;0;0;0
Salamanca;Suazilandia;31/12/2021;0;0;0
Salamanca;Sudáfrica;31/12/2021;0;0;0
Salamanca;Sudán;31/12/2021;0;0;0
Salamanca;Surinam;31/12/2021;0;0;0
Salamanca;Tailandia;31/12/2021;2;0;2
Salamanca;Taiwán;31/12/2021;3;1;2
Salamanca;Tanzania;31/12/2021;1;1;0
Salamanca;Tayikistán;31/12/2021;0;0;0
Salamanca;Togo;31/12/2021;0;0;0
Salamanca;Trinidad y Tobago;31/12/2021;0;0;0
Salamanca;Túnez;31/12/2021;0;0;0
Salamanca;Turkmenistán;31/12/2021;0;0;0
Salamanca;Turquía;31/12/2021;2;1;1
Salamanca;Ucrania;31/12/2021;6;3;3
Salamanca;Uganda;31/12/2021;0;0;0
Salamanca;Uruguay;31/12/2021;3;1;2
Salamanca;Uzbekistán;31/12/2021;0;0;0
Salamanca;Vanuatu;31/12/2021;0;0;0
Salamanca;Venezuela;31/12/2021;21;12;9
Salamanca;Vietnam;31/12/2021;4;2;2
Salamanca;Yemen;31/12/2021;0;0;0
Salamanca;Yibuti;31/12/2021;0;0;0
Salamanca;Zambia;31/12/2021;0;0;0
Salamanca;Zimbabue;31/12/2021;0;0;0
Salamanca;Todas las nacionalidades;31/12/2020;1122;440;682
Salamanca;Afganistán;31/12/2020;0;0;0
Salamanca;Albania;31/12/2020;1;1;0
Salamanca;Andorra;31/12/2020;0;0;0
Salamanca;Angola;31/12/2020;1;1;0
Salamanca;Antigua y Barbuda;31/12/2020;0;0;0
Salamanca;Arabia Saudí;31/12/2020;3;2;1
Salamanca;Argelia;31/12/2020;16;5;11
Salamanca;Argentina;31/12/2020;11;3;8
Salamanca;Armenia;31/12/2020;0;0;0
Salamanca;Australia;31/12/2020;2;1;1
Salamanca;Azerbaiyán;31/12/2020;0;0;0
Salamanca;Bahamas;31/12/2020;0;0;0
Salamanca;Bahrein;31/12/2020;0;0;0
Salamanca;Bangladés;31/12/2020;0;0;0
Salamanca;Barbados;31/12/2020;0;0;0
Salamanca;Belice;31/12/2020;0;0;0
Salamanca;Benín;31/12/2020;1;1;0
Salamanca;Bielorrusia;31/12/2020;2;1;1
Salamanca;Bolivia;31/12/2020;22;8;14
Salamanca;Bosnia-Herzegovina;31/12/2020;0;0;0
Salamanca;Botsuana;31/12/2020;0;0;0
Salamanca;Brasil;31/12/2020;84;34;50
Salamanca;Brunei;31/12/2020;0;0;0
Salamanca;Burkina Faso;31/12/2020;0;0;0
Salamanca;Burundi;31/12/2020;0;0;0
Salamanca;Bután;31/12/2020;0;0;0
Salamanca;Cabo Verde;31/12/2020;0;0;0
Salamanca;Camboya;31/12/2020;0;0;0
Salamanca;Camerún;31/12/2020;4;3;1
Salamanca;Canadá;31/12/2020;2;0;2
Salamanca;Chad;31/12/2020;0;0;0
Salamanca;Chile;31/12/2020;31;15;16
Salamanca;China;31/12/2020;355;116;239
Salamanca;Colombia;31/12/2020;115;44;71
Salamanca;Comores;31/12/2020;0;0;0
Salamanca;Congo;31/12/2020;0;0;0
Salamanca;Corea del Norte;31/12/2020;0;0;0
Salamanca;Corea del Sur;31/12/2020;9;1;8
Salamanca;Costa de Marfil;31/12/2020;1;1;0
Salamanca;Costa Rica;31/12/2020;11;6;5
Salamanca;Cuba;31/12/2020;13;4;9
Salamanca;Dominica;31/12/2020;0;0;0
Salamanca;Ecuador;31/12/2020;69;31;38
Salamanca;Egipto;31/12/2020;4;4;0
Salamanca;El Salvador;31/12/2020;8;5;3
Salamanca;Emiratos Árabes Unidos;31/12/2020;0;0;0
Salamanca;Eritrea;31/12/2020;0;0;0
Salamanca;Estados Unidos;31/12/2020;25;15;10
Salamanca;Etiopía;31/12/2020;0;0;0
Salamanca;Filipinas;31/12/2020;1;1;0
Salamanca;Fiyi;31/12/2020;0;0;0
Salamanca;Gabón;31/12/2020;0;0;0
Salamanca;Gambia;31/12/2020;0;0;0
Salamanca;Georgia;31/12/2020;0;0;0
Salamanca;Ghana;31/12/2020;0;0;0
Salamanca;Granada;31/12/2020;0;0;0
Salamanca;Guatemala;31/12/2020;9;3;6
Salamanca;Guinea;31/12/2020;0;0;0
Salamanca;Guinea Bissau;31/12/2020;0;0;0
Salamanca;Guinea Ecuatorial;31/12/2020;51;23;28
Salamanca;Guyana;31/12/2020;0;0;0
Salamanca;Haití;31/12/2020;4;1;3
Salamanca;Honduras;31/12/2020;27;12;15
Salamanca;India;31/12/2020;3;2;1
Salamanca;Indonesia;31/12/2020;2;1;1
Salamanca;Irak;31/12/2020;0;0;0
Salamanca;Irán;31/12/2020;1;1;0
Salamanca;Islas Salomón;31/12/2020;0;0;0
Salamanca;Israel;31/12/2020;1;1;0
Salamanca;Jamaica;31/12/2020;0;0;0
Salamanca;Japón;31/12/2020;8;1;7
Salamanca;Jordania;31/12/2020;0;0;0
Salamanca;Kazajistán;31/12/2020;1;1;0
Salamanca;Kenia;31/12/2020;0;0;0
Salamanca;Kirguistán;31/12/2020;0;0;0
Salamanca;Kuwait;31/12/2020;0;0;0
Salamanca;Laos;31/12/2020;0;0;0
Salamanca;Lesoto;31/12/2020;0;0;0
Salamanca;Líbano;31/12/2020;0;0;0
Salamanca;Liberia;31/12/2020;0;0;0
Salamanca;Libia;31/12/2020;1;0;1
Salamanca;Macedonia;31/12/2020;0;0;0
Salamanca;Madagascar;31/12/2020;0;0;0
Salamanca;Malasia;31/12/2020;1;0;1
Salamanca;Malaui;31/12/2020;0;0;0
Salamanca;Maldivas;31/12/2020;0;0;0
Salamanca;Mali;31/12/2020;0;0;0
Salamanca;Marruecos;31/12/2020;38;14;24
Salamanca;Mauricio;31/12/2020;0;0;0
Salamanca;Mauritania;31/12/2020;0;0;0
Salamanca;México;31/12/2020;35;13;22
Salamanca;Micronesia;31/12/2020;0;0;0
Salamanca;Moldavia;31/12/2020;0;0;0
Salamanca;Mónaco;31/12/2020;0;0;0
Salamanca;Mongolia;31/12/2020;0;0;0
Salamanca;Montenegro;31/12/2020;0;0;0
Salamanca;Mozambique;31/12/2020;0;0;0
Salamanca;Myanmar;31/12/2020;0;0;0
Salamanca;Namibia;31/12/2020;0;0;0
Salamanca;Nepal;31/12/2020;0;0;0
Salamanca;Nicaragua;31/12/2020;3;3;0
Salamanca;Níger;31/12/2020;0;0;0
Salamanca;Nigeria;31/12/2020;0;0;0
Salamanca;Nueva Zelanda;31/12/2020;0;0;0
Salamanca;Oceanía (No consta país);31/12/2020;0;0;0
Salamanca;Omán;31/12/2020;0;0;0
Salamanca;Pakistán;31/12/2020;0;0;0
Salamanca;Palestina;31/12/2020;0;0;0
Salamanca;Panamá;31/12/2020;14;6;8
Salamanca;Papúa Nueva Guinea;31/12/2020;0;0;0
Salamanca;Paraguay;31/12/2020;4;2;2
Salamanca;Perú;31/12/2020;42;22;20
Salamanca;Qatar;31/12/2020;0;0;0
Salamanca;Reino Unido;31/12/2020;0;0;0
Salamanca;Rep. Centroafricana;31/12/2020;0;0;0
Salamanca;Rep. Dem. del Congo;31/12/2020;0;0;0
Salamanca;República Dominicana;31/12/2020;26;6;20
Salamanca;Ruanda;31/12/2020;0;0;0
Salamanca;Rusia;31/12/2020;13;2;11
Salamanca;Samoa;31/12/2020;0;0;0
Salamanca;San Cristóbal y Nieves;31/12/2020;0;0;0
Salamanca;San Marino;31/12/2020;0;0;0
Salamanca;San Vicente y Granadinas;31/12/2020;0;0;0
Salamanca;Santa Lucía;31/12/2020;0;0;0
Salamanca;Santo Tomé y Príncipe;31/12/2020;0;0;0
Salamanca;Senegal;31/12/2020;0;0;0
Salamanca;Serbia;31/12/2020;0;0;0
Salamanca;Seychelles;31/12/2020;0;0;0
Salamanca;Sierra Leona;31/12/2020;0;0;0
Salamanca;Singapur;31/12/2020;0;0;0
Salamanca;Siria;31/12/2020;0;0;0
Salamanca;Somalia;31/12/2020;0;0;0
Salamanca;Sri Lanka;31/12/2020;0;0;0
Salamanca;Suazilandia;31/12/2020;0;0;0
Salamanca;Sudáfrica;31/12/2020;0;0;0
Salamanca;Sudán;31/12/2020;0;0;0
Salamanca;Surinam;31/12/2020;0;0;0
Salamanca;Tailandia;31/12/2020;1;0;1
Salamanca;Taiwán;31/12/2020;2;1;1
Salamanca;Tanzania;31/12/2020;0;0;0
Salamanca;Tayikistán;31/12/2020;0;0;0
Salamanca;Togo;31/12/2020;0;0;0
Salamanca;Trinidad y Tobago;31/12/2020;0;0;0
Salamanca;Túnez;31/12/2020;0;0;0
Salamanca;Turkmenistán;31/12/2020;0;0;0
Salamanca;Turquía;31/12/2020;5;1;4
Salamanca;Ucrania;31/12/2020;3;1;2
Salamanca;Uganda;31/12/2020;0;0;0
Salamanca;Uruguay;31/12/2020;3;2;1
Salamanca;Uzbekistán;31/12/2020;0;0;0
Salamanca;Vanuatu;31/12/2020;0;0;0
Salamanca;Venezuela;31/12/2020;28;16;12
Salamanca;Vietnam;31/12/2020;5;2;3
Salamanca;Yemen;31/12/2020;0;0;0
Salamanca;Yibuti;31/12/2020;0;0;0
Salamanca;Zambia;31/12/2020;0;0;0
Salamanca;Zimbabue;31/12/2020;0;0;0
Salamanca;Todas las nacionalidades;31/12/2019;2050;733;1317
Salamanca;Afganistán;31/12/2019;0;0;0
Salamanca;Albania;31/12/2019;1;1;0
Salamanca;Andorra;31/12/2019;1;1;0
Salamanca;Angola;31/12/2019;2;1;1
Salamanca;Antigua y Barbuda;31/12/2019;0;0;0
Salamanca;Arabia Saudí;31/12/2019;4;4;0
Salamanca;Argelia;31/12/2019;3;2;1
Salamanca;Argentina;31/12/2019;22;7;15
Salamanca;Armenia;31/12/2019;0;0;0
Salamanca;Australia;31/12/2019;1;1;0
Salamanca;Azerbaiyán;31/12/2019;0;0;0
Salamanca;Bahamas;31/12/2019;1;0;1
Salamanca;Bahrein;31/12/2019;0;0;0
Salamanca;Bangladés;31/12/2019;0;0;0
Salamanca;Barbados;31/12/2019;0;0;0
Salamanca;Belice;31/12/2019;0;0;0
Salamanca;Benín;31/12/2019;0;0;0
Salamanca;Bielorrusia;31/12/2019;2;1;1
Salamanca;Bolivia;31/12/2019;37;14;23
Salamanca;Bosnia-Herzegovina;31/12/2019;0;0;0
Salamanca;Botsuana;31/12/2019;0;0;0
Salamanca;Brasil;31/12/2019;118;48;70
Salamanca;Brunei;31/12/2019;0;0;0
Salamanca;Burkina Faso;31/12/2019;0;0;0
Salamanca;Burundi;31/12/2019;0;0;0
Salamanca;Bután;31/12/2019;0;0;0
Salamanca;Cabo Verde;31/12/2019;0;0;0
Salamanca;Camboya;31/12/2019;0;0;0
Salamanca;Camerún;31/12/2019;5;4;1
Salamanca;Canadá;31/12/2019;5;1;4
Salamanca;Chad;31/12/2019;0;0;0
Salamanca;Chile;31/12/2019;39;21;18
Salamanca;China;31/12/2019;694;203;491
Salamanca;Colombia;31/12/2019;174;65;109
Salamanca;Comores;31/12/2019;0;0;0
Salamanca;Congo;31/12/2019;0;0;0
Salamanca;Corea del Norte;31/12/2019;0;0;0
Salamanca;Corea del Sur;31/12/2019;28;9;19
Salamanca;Costa de Marfil;31/12/2019;2;2;0
Salamanca;Costa Rica;31/12/2019;24;9;15
Salamanca;Cuba;31/12/2019;13;5;8
Salamanca;Dominica;31/12/2019;0;0;0
Salamanca;Ecuador;31/12/2019;131;52;79
Salamanca;Egipto;31/12/2019;6;3;3
Salamanca;El Salvador;31/12/2019;10;4;6
Salamanca;Emiratos Árabes Unidos;31/12/2019;0;0;0
Salamanca;Eritrea;31/12/2019;0;0;0
Salamanca;Estados Unidos;31/12/2019;68;28;40
Salamanca;Etiopía;31/12/2019;1;0;1
Salamanca;Filipinas;31/12/2019;3;2;1
Salamanca;Fiyi;31/12/2019;0;0;0
Salamanca;Gabón;31/12/2019;0;0;0
Salamanca;Gambia;31/12/2019;0;0;0
Salamanca;Georgia;31/12/2019;0;0;0
Salamanca;Ghana;31/12/2019;6;1;5
Salamanca;Granada;31/12/2019;0;0;0
Salamanca;Guatemala;31/12/2019;16;7;9
Salamanca;Guinea;31/12/2019;0;0;0
Salamanca;Guinea Bissau;31/12/2019;0;0;0
Salamanca;Guinea Ecuatorial;31/12/2019;67;26;41
Salamanca;Guyana;31/12/2019;0;0;0
Salamanca;Haití;31/12/2019;4;2;2
Salamanca;Honduras;31/12/2019;53;24;29
Salamanca;India;31/12/2019;4;3;1
Salamanca;Indonesia;31/12/2019;3;2;1
Salamanca;Irak;31/12/2019;0;0;0
Salamanca;Irán;31/12/2019;1;0;1
Salamanca;Islas Salomón;31/12/2019;0;0;0
Salamanca;Israel;31/12/2019;3;3;0
Salamanca;Jamaica;31/12/2019;0;0;0
Salamanca;Japón;31/12/2019;64;17;47
Salamanca;Jordania;31/12/2019;0;0;0
Salamanca;Kazajistán;31/12/2019;2;0;2
Salamanca;Kenia;31/12/2019;0;0;0
Salamanca;Kirguistán;31/12/2019;0;0;0
Salamanca;Kuwait;31/12/2019;0;0;0
Salamanca;Laos;31/12/2019;0;0;0
Salamanca;Lesoto;31/12/2019;0;0;0
Salamanca;Líbano;31/12/2019;1;1;0
Salamanca;Liberia;31/12/2019;0;0;0
Salamanca;Libia;31/12/2019;1;0;1
Salamanca;Macedonia;31/12/2019;0;0;0
Salamanca;Madagascar;31/12/2019;2;1;1
Salamanca;Malasia;31/12/2019;1;0;1
Salamanca;Malaui;31/12/2019;0;0;0
Salamanca;Maldivas;31/12/2019;0;0;0
Salamanca;Mali;31/12/2019;0;0;0
Salamanca;Marruecos;31/12/2019;37;15;22
Salamanca;Mauricio;31/12/2019;0;0;0
Salamanca;Mauritania;31/12/2019;1;1;0
Salamanca;México;31/12/2019;84;33;51
Salamanca;Micronesia;31/12/2019;0;0;0
Salamanca;Moldavia;31/12/2019;0;0;0
Salamanca;Mónaco;31/12/2019;0;0;0
Salamanca;Mongolia;31/12/2019;0;0;0
Salamanca;Montenegro;31/12/2019;0;0;0
Salamanca;Mozambique;31/12/2019;2;1;1
Salamanca;Myanmar;31/12/2019;0;0;0
Salamanca;Namibia;31/12/2019;0;0;0
Salamanca;Nepal;31/12/2019;0;0;0
Salamanca;Nicaragua;31/12/2019;4;3;1
Salamanca;Níger;31/12/2019;0;0;0
Salamanca;Nigeria;31/12/2019;0;0;0
Salamanca;Nueva Zelanda;31/12/2019;0;0;0
Salamanca;Oceanía (No consta país);31/12/2019;0;0;0
Salamanca;Omán;31/12/2019;0;0;0
Salamanca;Pakistán;31/12/2019;0;0;0
Salamanca;Palestina;31/12/2019;0;0;0
Salamanca;Panamá;31/12/2019;13;5;8
Salamanca;Papúa Nueva Guinea;31/12/2019;0;0;0
Salamanca;Paraguay;31/12/2019;11;6;5
Salamanca;Perú;31/12/2019;86;41;45
Salamanca;Qatar;31/12/2019;0;0;0
Salamanca;Reino Unido;31/12/2019;0;0;0
Salamanca;Rep. Centroafricana;31/12/2019;0;0;0
Salamanca;Rep. Dem. del Congo;31/12/2019;0;0;0
Salamanca;República Dominicana;31/12/2019;73;19;54
Salamanca;Ruanda;31/12/2019;0;0;0
Salamanca;Rusia;31/12/2019;17;6;11
Salamanca;Samoa;31/12/2019;0;0;0
Salamanca;San Cristóbal y Nieves;31/12/2019;0;0;0
Salamanca;San Marino;31/12/2019;0;0;0
Salamanca;San Vicente y Granadinas;31/12/2019;0;0;0
Salamanca;Santa Lucía;31/12/2019;0;0;0
Salamanca;Santo Tomé y Príncipe;31/12/2019;0;0;0
Salamanca;Senegal;31/12/2019;2;1;1
Salamanca;Serbia;31/12/2019;1;0;1
Salamanca;Seychelles;31/12/2019;0;0;0
Salamanca;Sierra Leona;31/12/2019;0;0;0
Salamanca;Singapur;31/12/2019;1;0;1
Salamanca;Siria;31/12/2019;0;0;0
Salamanca;Somalia;31/12/2019;0;0;0
Salamanca;Sri Lanka;31/12/2019;0;0;0
Salamanca;Suazilandia;31/12/2019;0;0;0
Salamanca;Sudáfrica;31/12/2019;0;0;0
Salamanca;Sudán;31/12/2019;0;0;0
Salamanca;Surinam;31/12/2019;0;0;0
Salamanca;Tailandia;31/12/2019;2;0;2
Salamanca;Taiwán;31/12/2019;36;2;34
Salamanca;Tanzania;31/12/2019;0;0;0
Salamanca;Tayikistán;31/12/2019;0;0;0
Salamanca;Togo;31/12/2019;0;0;0
Salamanca;Trinidad y Tobago;31/12/2019;0;0;0
Salamanca;Túnez;31/12/2019;0;0;0
Salamanca;Turkmenistán;31/12/2019;0;0;0
Salamanca;Turquía;31/12/2019;10;2;8
Salamanca;Ucrania;31/12/2019;6;1;5
Salamanca;Uganda;31/12/2019;0;0;0
Salamanca;Uruguay;31/12/2019;8;5;3
Salamanca;Uzbekistán;31/12/2019;0;0;0
Salamanca;Vanuatu;31/12/2019;0;0;0
Salamanca;Venezuela;31/12/2019;26;14;12
Salamanca;Vietnam;31/12/2019;7;3;4
Salamanca;Yemen;31/12/2019;0;0;0
Salamanca;Yibuti;31/12/2019;0;0;0
Salamanca;Zambia;31/12/2019;0;0;0
Salamanca;Zimbabue;31/12/2019;0;0;0
Salamanca;Todas las nacionalidades;31/12/2018;2057;768;1289
Salamanca;Afganistán;31/12/2018;0;0;0
Salamanca;Albania;31/12/2018;1;1;0
Salamanca;Andorra;31/12/2018;1;1;0
Salamanca;Angola;31/12/2018;1;1;0
Salamanca;Antigua y Barbuda;31/12/2018;0;0;0
Salamanca;Arabia Saudí;31/12/2018;4;3;1
Salamanca;Argelia;31/12/2018;3;1;2
Salamanca;Argentina;31/12/2018;24;8;16
Salamanca;Armenia;31/12/2018;0;0;0
Salamanca;Australia;31/12/2018;0;0;0
Salamanca;Azerbaiyán;31/12/2018;0;0;0
Salamanca;Bahamas;31/12/2018;0;0;0
Salamanca;Bahrein;31/12/2018;0;0;0
Salamanca;Bangladés;31/12/2018;0;0;0
Salamanca;Barbados;31/12/2018;0;0;0
Salamanca;Belice;31/12/2018;0;0;0
Salamanca;Benín;31/12/2018;0;0;0
Salamanca;Bielorrusia;31/12/2018;1;0;1
Salamanca;Bolivia;31/12/2018;36;14;22
Salamanca;Bosnia-Herzegovina;31/12/2018;0;0;0
Salamanca;Botsuana;31/12/2018;0;0;0
Salamanca;Brasil;31/12/2018;123;52;71
Salamanca;Brunei;31/12/2018;0;0;0
Salamanca;Burkina Faso;31/12/2018;0;0;0
Salamanca;Burundi;31/12/2018;0;0;0
Salamanca;Bután;31/12/2018;0;0;0
Salamanca;Cabo Verde;31/12/2018;0;0;0
Salamanca;Camboya;31/12/2018;0;0;0
Salamanca;Camerún;31/12/2018;1;1;0
Salamanca;Canadá;31/12/2018;5;2;3
Salamanca;Chad;31/12/2018;0;0;0
Salamanca;Chile;31/12/2018;37;19;18
Salamanca;China;31/12/2018;802;233;569
Salamanca;Colombia;31/12/2018;165;74;91
Salamanca;Comores;31/12/2018;0;0;0
Salamanca;Congo;31/12/2018;0;0;0
Salamanca;Corea del Norte;31/12/2018;0;0;0
Salamanca;Corea del Sur;31/12/2018;28;16;12
Salamanca;Costa de Marfil;31/12/2018;1;1;0
Salamanca;Costa Rica;31/12/2018;24;13;11
Salamanca;Cuba;31/12/2018;12;2;10
Salamanca;Dominica;31/12/2018;0;0;0
Salamanca;Ecuador;31/12/2018;113;54;59
Salamanca;Egipto;31/12/2018;5;3;2
Salamanca;El Salvador;31/12/2018;9;3;6
Salamanca;Emiratos Árabes Unidos;31/12/2018;0;0;0
Salamanca;Eritrea;31/12/2018;0;0;0
Salamanca;Estados Unidos;31/12/2018;53;26;27
Salamanca;Etiopía;31/12/2018;0;0;0
Salamanca;Filipinas;31/12/2018;7;1;6
Salamanca;Fiyi;31/12/2018;0;0;0
Salamanca;Gabón;31/12/2018;0;0;0
Salamanca;Gambia;31/12/2018;0;0;0
Salamanca;Georgia;31/12/2018;0;0;0
Salamanca;Ghana;31/12/2018;0;0;0
Salamanca;Granada;31/12/2018;0;0;0
Salamanca;Guatemala;31/12/2018;6;3;3
Salamanca;Guinea;31/12/2018;1;1;0
Salamanca;Guinea Bissau;31/12/2018;0;0;0
Salamanca;Guinea Ecuatorial;31/12/2018;55;20;35
Salamanca;Guyana;31/12/2018;0;0;0
Salamanca;Haití;31/12/2018;5;4;1
Salamanca;Honduras;31/12/2018;40;19;21
Salamanca;India;31/12/2018;4;3;1
Salamanca;Indonesia;31/12/2018;3;2;1
Salamanca;Irak;31/12/2018;0;0;0
Salamanca;Irán;31/12/2018;2;0;2
Salamanca;Islas Salomón;31/12/2018;0;0;0
Salamanca;Israel;31/12/2018;1;1;0
Salamanca;Jamaica;31/12/2018;0;0;0
Salamanca;Japón;31/12/2018;74;33;41
Salamanca;Jordania;31/12/2018;0;0;0
Salamanca;Kazajistán;31/12/2018;2;0;2
Salamanca;Kenia;31/12/2018;0;0;0
Salamanca;Kirguistán;31/12/2018;0;0;0
Salamanca;Kuwait;31/12/2018;0;0;0
Salamanca;Laos;31/12/2018;0;0;0
Salamanca;Lesoto;31/12/2018;0;0;0
Salamanca;Líbano;31/12/2018;1;1;0
Salamanca;Liberia;31/12/2018;0;0;0
Salamanca;Libia;31/12/2018;1;0;1
Salamanca;Macedonia;31/12/2018;0;0;0
Salamanca;Madagascar;31/12/2018;1;1;0
Salamanca;Malasia;31/12/2018;1;1;0
Salamanca;Malaui;31/12/2018;0;0;0
Salamanca;Maldivas;31/12/2018;0;0;0
Salamanca;Mali;31/12/2018;0;0;0
Salamanca;Marruecos;31/12/2018;18;9;9
Salamanca;Mauricio;31/12/2018;0;0;0
Salamanca;Mauritania;31/12/2018;1;1;0
Salamanca;México;31/12/2018;80;34;46
Salamanca;Micronesia;31/12/2018;0;0;0
Salamanca;Moldavia;31/12/2018;0;0;0
Salamanca;Mónaco;31/12/2018;0;0;0
Salamanca;Mongolia;31/12/2018;0;0;0
Salamanca;Montenegro;31/12/2018;0;0;0
Salamanca;Mozambique;31/12/2018;2;1;1
Salamanca;Myanmar;31/12/2018;0;0;0
Salamanca;Namibia;31/12/2018;0;0;0
Salamanca;Nepal;31/12/2018;0;0;0
Salamanca;Nicaragua;31/12/2018;3;1;2
Salamanca;Níger;31/12/2018;0;0;0
Salamanca;Nigeria;31/12/2018;1;1;0
Salamanca;Nueva Zelanda;31/12/2018;1;0;1
Salamanca;Oceanía (No consta país);31/12/2018;0;0;0
Salamanca;Omán;31/12/2018;0;0;0
Salamanca;Pakistán;31/12/2018;0;0;0
Salamanca;Palestina;31/12/2018;0;0;0
Salamanca;Panamá;31/12/2018;19;6;13
Salamanca;Papúa Nueva Guinea;31/12/2018;0;0;0
Salamanca;Paraguay;31/12/2018;6;3;3
Salamanca;Perú;31/12/2018;73;29;44
Salamanca;Qatar;31/12/2018;1;1;0
Salamanca;Reino Unido;31/12/2018;0;0;0
Salamanca;Rep. Centroafricana;31/12/2018;0;0;0
Salamanca;Rep. Dem. del Congo;31/12/2018;0;0;0
Salamanca;República Dominicana;31/12/2018;78;18;60
Salamanca;Ruanda;31/12/2018;0;0;0
Salamanca;Rusia;31/12/2018;9;2;7
Salamanca;Samoa;31/12/2018;0;0;0
Salamanca;San Cristóbal y Nieves;31/12/2018;0;0;0
Salamanca;San Marino;31/12/2018;0;0;0
Salamanca;San Vicente y Granadinas;31/12/2018;0;0;0
Salamanca;Santa Lucía;31/12/2018;0;0;0
Salamanca;Santo Tomé y Príncipe;31/12/2018;0;0;0
Salamanca;Senegal;31/12/2018;1;0;1
Salamanca;Serbia;31/12/2018;0;0;0
Salamanca;Seychelles;31/12/2018;0;0;0
Salamanca;Sierra Leona;31/12/2018;0;0;0
Salamanca;Singapur;31/12/2018;0;0;0
Salamanca;Siria;31/12/2018;0;0;0
Salamanca;Somalia;31/12/2018;0;0;0
Salamanca;Sri Lanka;31/12/2018;0;0;0
Salamanca;Suazilandia;31/12/2018;0;0;0
Salamanca;Sudáfrica;31/12/2018;0;0;0
Salamanca;Sudán;31/12/2018;0;0;0
Salamanca;Surinam;31/12/2018;0;0;0
Salamanca;Tailandia;31/12/2018;3;1;2
Salamanca;Taiwán;31/12/2018;48;14;34
Salamanca;Tanzania;31/12/2018;0;0;0
Salamanca;Tayikistán;31/12/2018;0;0;0
Salamanca;Togo;31/12/2018;0;0;0
Salamanca;Trinidad y Tobago;31/12/2018;0;0;0
Salamanca;Túnez;31/12/2018;1;0;1
Salamanca;Turkmenistán;31/12/2018;0;0;0
Salamanca;Turquía;31/12/2018;13;6;7
Salamanca;Ucrania;31/12/2018;4;2;2
Salamanca;Uganda;31/12/2018;0;0;0
Salamanca;Uruguay;31/12/2018;9;7;2
Salamanca;Uzbekistán;31/12/2018;0;0;0
Salamanca;Vanuatu;31/12/2018;0;0;0
Salamanca;Venezuela;31/12/2018;27;12;15
Salamanca;Vietnam;31/12/2018;6;2;4
Salamanca;Yemen;31/12/2018;0;0;0
Salamanca;Yibuti;31/12/2018;0;0;0
Salamanca;Zambia;31/12/2018;0;0;0
Salamanca;Zimbabue;31/12/2018;0;0;0
Salamanca;Todas las nacionalidades;31/12/2017;1905;723;1182
Salamanca;Afganistán;31/12/2017;0;0;0
Salamanca;Albania;31/12/2017;2;1;1
Salamanca;Andorra;31/12/2017;1;1;0
Salamanca;Angola;31/12/2017;3;2;1
Salamanca;Antigua y Barbuda;31/12/2017;0;0;0
Salamanca;Arabia Saudí;31/12/2017;1;0;1
Salamanca;Argelia;31/12/2017;3;0;3
Salamanca;Argentina;31/12/2017;17;5;12
Salamanca;Armenia;31/12/2017;0;0;0
Salamanca;Australia;31/12/2017;1;1;0
Salamanca;Azerbaiyán;31/12/2017;0;0;0
Salamanca;Bahamas;31/12/2017;0;0;0
Salamanca;Bahrein;31/12/2017;0;0;0
Salamanca;Bangladés;31/12/2017;0;0;0
Salamanca;Barbados;31/12/2017;0;0;0
Salamanca;Belice;31/12/2017;0;0;0
Salamanca;Benín;31/12/2017;1;1;0
Salamanca;Bielorrusia;31/12/2017;1;0;1
Salamanca;Bolivia;31/12/2017;46;22;24
Salamanca;Bosnia-Herzegovina;31/12/2017;0;0;0
Salamanca;Botsuana;31/12/2017;0;0;0
Salamanca;Brasil;31/12/2017;108;52;56
Salamanca;Brunei;31/12/2017;0;0;0
Salamanca;Burkina Faso;31/12/2017;0;0;0
Salamanca;Burundi;31/12/2017;0;0;0
Salamanca;Bután;31/12/2017;0;0;0
Salamanca;Cabo Verde;31/12/2017;1;0;1
Salamanca;Camboya;31/12/2017;0;0;0
Salamanca;Camerún;31/12/2017;2;2;0
Salamanca;Canadá;31/12/2017;2;1;1
Salamanca;Chad;31/12/2017;0;0;0
Salamanca;Chile;31/12/2017;36;22;14
Salamanca;China;31/12/2017;819;251;568
Salamanca;Colombia;31/12/2017;120;58;62
Salamanca;Comores;31/12/2017;0;0;0
Salamanca;Congo;31/12/2017;0;0;0
Salamanca;Corea del Norte;31/12/2017;0;0;0
Salamanca;Corea del Sur;31/12/2017;30;10;20
Salamanca;Costa de Marfil;31/12/2017;2;2;0
Salamanca;Costa Rica;31/12/2017;19;10;9
Salamanca;Cuba;31/12/2017;4;1;3
Salamanca;Dominica;31/12/2017;1;0;1
Salamanca;Ecuador;31/12/2017;97;46;51
Salamanca;Egipto;31/12/2017;6;1;5
Salamanca;El Salvador;31/12/2017;11;4;7
Salamanca;Emiratos Árabes Unidos;31/12/2017;0;0;0
Salamanca;Eritrea;31/12/2017;0;0;0
Salamanca;Estados Unidos;31/12/2017;45;19;26
Salamanca;Etiopía;31/12/2017;0;0;0
Salamanca;Filipinas;31/12/2017;3;0;3
Salamanca;Fiyi;31/12/2017;0;0;0
Salamanca;Gabón;31/12/2017;0;0;0
Salamanca;Gambia;31/12/2017;0;0;0
Salamanca;Georgia;31/12/2017;0;0;0
Salamanca;Ghana;31/12/2017;0;0;0
Salamanca;Granada;31/12/2017;0;0;0
Salamanca;Guatemala;31/12/2017;5;1;4
Salamanca;Guinea;31/12/2017;0;0;0
Salamanca;Guinea Bissau;31/12/2017;0;0;0
Salamanca;Guinea Ecuatorial;31/12/2017;46;21;25
Salamanca;Guyana;31/12/2017;0;0;0
Salamanca;Haití;31/12/2017;3;3;0
Salamanca;Honduras;31/12/2017;44;24;20
Salamanca;India;31/12/2017;3;3;0
Salamanca;Indonesia;31/12/2017;2;2;0
Salamanca;Irak;31/12/2017;0;0;0
Salamanca;Irán;31/12/2017;2;0;2
Salamanca;Islas Salomón;31/12/2017;0;0;0
Salamanca;Israel;31/12/2017;0;0;0
Salamanca;Jamaica;31/12/2017;1;0;1
Salamanca;Japón;31/12/2017;62;22;40
Salamanca;Jordania;31/12/2017;0;0;0
Salamanca;Kazajistán;31/12/2017;2;0;2
Salamanca;Kenia;31/12/2017;0;0;0
Salamanca;Kirguistán;31/12/2017;0;0;0
Salamanca;Kuwait;31/12/2017;0;0;0
Salamanca;Laos;31/12/2017;0;0;0
Salamanca;Lesoto;31/12/2017;0;0;0
Salamanca;Líbano;31/12/2017;1;1;0
Salamanca;Liberia;31/12/2017;0;0;0
Salamanca;Libia;31/12/2017;6;4;2
Salamanca;Macedonia;31/12/2017;0;0;0
Salamanca;Madagascar;31/12/2017;1;1;0
Salamanca;Malasia;31/12/2017;0;0;0
Salamanca;Malaui;31/12/2017;0;0;0
Salamanca;Maldivas;31/12/2017;0;0;0
Salamanca;Mali;31/12/2017;0;0;0
Salamanca;Marruecos;31/12/2017;17;4;13
Salamanca;Mauricio;31/12/2017;0;0;0
Salamanca;Mauritania;31/12/2017;0;0;0
Salamanca;México;31/12/2017;69;28;41
Salamanca;Micronesia;31/12/2017;0;0;0
Salamanca;Moldavia;31/12/2017;0;0;0
Salamanca;Mónaco;31/12/2017;0;0;0
Salamanca;Mongolia;31/12/2017;0;0;0
Salamanca;Montenegro;31/12/2017;0;0;0
Salamanca;Mozambique;31/12/2017;1;0;1
Salamanca;Myanmar;31/12/2017;0;0;0
Salamanca;Namibia;31/12/2017;0;0;0
Salamanca;Nepal;31/12/2017;0;0;0
Salamanca;Nicaragua;31/12/2017;4;1;3
Salamanca;Níger;31/12/2017;0;0;0
Salamanca;Nigeria;31/12/2017;1;1;0
Salamanca;Nueva Zelanda;31/12/2017;1;1;0
Salamanca;Oceanía (No consta país);31/12/2017;0;0;0
Salamanca;Omán;31/12/2017;0;0;0
Salamanca;Pakistán;31/12/2017;0;0;0
Salamanca;Palestina;31/12/2017;0;0;0
Salamanca;Panamá;31/12/2017;20;7;13
Salamanca;Papúa Nueva Guinea;31/12/2017;0;0;0
Salamanca;Paraguay;31/12/2017;6;3;3
Salamanca;Perú;31/12/2017;73;34;39
Salamanca;Qatar;31/12/2017;0;0;0
Salamanca;Reino Unido;31/12/2017;0;0;0
Salamanca;Rep. Centroafricana;31/12/2017;0;0;0
Salamanca;Rep. Dem. del Congo;31/12/2017;0;0;0
Salamanca;República Dominicana;31/12/2017;45;14;31
Salamanca;Ruanda;31/12/2017;0;0;0
Salamanca;Rusia;31/12/2017;13;1;12
Salamanca;Samoa;31/12/2017;0;0;0
Salamanca;San Cristóbal y Nieves;31/12/2017;0;0;0
Salamanca;San Marino;31/12/2017;0;0;0
Salamanca;San Vicente y Granadinas;31/12/2017;0;0;0
Salamanca;Santa Lucía;31/12/2017;0;0;0
Salamanca;Santo Tomé y Príncipe;31/12/2017;0;0;0
Salamanca;Senegal;31/12/2017;0;0;0
Salamanca;Serbia;31/12/2017;1;0;1
Salamanca;Seychelles;31/12/2017;0;0;0
Salamanca;Sierra Leona;31/12/2017;0;0;0
Salamanca;Singapur;31/12/2017;0;0;0
Salamanca;Siria;31/12/2017;1;0;1
Salamanca;Somalia;31/12/2017;0;0;0
Salamanca;Sri Lanka;31/12/2017;0;0;0
Salamanca;Suazilandia;31/12/2017;0;0;0
Salamanca;Sudáfrica;31/12/2017;0;0;0
Salamanca;Sudán;31/12/2017;0;0;0
Salamanca;Surinam;31/12/2017;0;0;0
Salamanca;Tailandia;31/12/2017;4;1;3
Salamanca;Taiwán;31/12/2017;37;11;26
Salamanca;Tanzania;31/12/2017;0;0;0
Salamanca;Tayikistán;31/12/2017;0;0;0
Salamanca;Togo;31/12/2017;0;0;0
Salamanca;Trinidad y Tobago;31/12/2017;0;0;0
Salamanca;Túnez;31/12/2017;0;0;0
Salamanca;Turkmenistán;31/12/2017;0;0;0
Salamanca;Turquía;31/12/2017;6;4;2
Salamanca;Ucrania;31/12/2017;11;3;8
Salamanca;Uganda;31/12/2017;0;0;0
Salamanca;Uruguay;31/12/2017;5;3;2
Salamanca;Uzbekistán;31/12/2017;0;0;0
Salamanca;Vanuatu;31/12/2017;0;0;0
Salamanca;Venezuela;31/12/2017;25;11;14
Salamanca;Vietnam;31/12/2017;5;2;3
Salamanca;Yemen;31/12/2017;0;0;0
Salamanca;Yibuti;31/12/2017;0;0;0
Salamanca;Zambia;31/12/2017;0;0;0
Salamanca;Zimbabue;31/12/2017;0;0;0
Salamanca;Todas las nacionalidades;31/12/2016;1795;627;1168
Salamanca;Afganistán;31/12/2016;0;0;0
Salamanca;Albania;31/12/2016;3;1;2
Salamanca;Andorra;31/12/2016;1;1;0
Salamanca;Angola;31/12/2016;2;1;1
Salamanca;Antigua y Barbuda;31/12/2016;0;0;0
Salamanca;Arabia Saudí;31/12/2016;5;3;2
Salamanca;Argelia;31/12/2016;3;1;2
Salamanca;Argentina;31/12/2016;24;5;19
Salamanca;Armenia;31/12/2016;0;0;0
Salamanca;Australia;31/12/2016;0;0;0
Salamanca;Azerbaiyán;31/12/2016;0;0;0
Salamanca;Bahamas;31/12/2016;0;0;0
Salamanca;Bahrein;31/12/2016;0;0;0
Salamanca;Bangladés;31/12/2016;0;0;0
Salamanca;Barbados;31/12/2016;0;0;0
Salamanca;Belice;31/12/2016;0;0;0
Salamanca;Benín;31/12/2016;0;0;0
Salamanca;Bielorrusia;31/12/2016;2;1;1
Salamanca;Bolivia;31/12/2016;40;20;20
Salamanca;Bosnia-Herzegovina;31/12/2016;0;0;0
Salamanca;Botsuana;31/12/2016;0;0;0
Salamanca;Brasil;31/12/2016;112;55;57
Salamanca;Brunei;31/12/2016;0;0;0
Salamanca;Burkina Faso;31/12/2016;1;1;0
Salamanca;Burundi;31/12/2016;0;0;0
Salamanca;Bután;31/12/2016;0;0;0
Salamanca;Cabo Verde;31/12/2016;0;0;0
Salamanca;Camboya;31/12/2016;0;0;0
Salamanca;Camerún;31/12/2016;2;2;0
Salamanca;Canadá;31/12/2016;1;0;1
Salamanca;Chad;31/12/2016;1;1;0
Salamanca;Chile;31/12/2016;13;7;6
Salamanca;China;31/12/2016;736;196;540
Salamanca;Colombia;31/12/2016;113;48;65
Salamanca;Comores;31/12/2016;0;0;0
Salamanca;Congo;31/12/2016;0;0;0
Salamanca;Corea del Norte;31/12/2016;0;0;0
Salamanca;Corea del Sur;31/12/2016;43;15;28
Salamanca;Costa de Marfil;31/12/2016;2;2;0
Salamanca;Costa Rica;31/12/2016;13;5;8
Salamanca;Cuba;31/12/2016;3;1;2
Salamanca;Dominica;31/12/2016;0;0;0
Salamanca;Ecuador;31/12/2016;80;39;41
Salamanca;Egipto;31/12/2016;4;2;2
Salamanca;El Salvador;31/12/2016;9;3;6
Salamanca;Emiratos Árabes Unidos;31/12/2016;0;0;0
Salamanca;Eritrea;31/12/2016;0;0;0
Salamanca;Estados Unidos;31/12/2016;47;16;31
Salamanca;Etiopía;31/12/2016;0;0;0
Salamanca;Filipinas;31/12/2016;1;0;1
Salamanca;Fiyi;31/12/2016;0;0;0
Salamanca;Gabón;31/12/2016;1;1;0
Salamanca;Gambia;31/12/2016;0;0;0
Salamanca;Georgia;31/12/2016;0;0;0
Salamanca;Ghana;31/12/2016;0;0;0
Salamanca;Granada;31/12/2016;0;0;0
Salamanca;Guatemala;31/12/2016;7;2;5
Salamanca;Guinea;31/12/2016;0;0;0
Salamanca;Guinea Bissau;31/12/2016;0;0;0
Salamanca;Guinea Ecuatorial;31/12/2016;41;15;26
Salamanca;Guyana;31/12/2016;0;0;0
Salamanca;Haití;31/12/2016;1;1;0
Salamanca;Honduras;31/12/2016;15;9;6
Salamanca;India;31/12/2016;4;3;1
Salamanca;Indonesia;31/12/2016;2;2;0
Salamanca;Irak;31/12/2016;0;0;0
Salamanca;Irán;31/12/2016;1;0;1
Salamanca;Islas Salomón;31/12/2016;0;0;0
Salamanca;Israel;31/12/2016;1;1;0
Salamanca;Jamaica;31/12/2016;0;0;0
Salamanca;Japón;31/12/2016;70;26;44
Salamanca;Jordania;31/12/2016;2;1;1
Salamanca;Kazajistán;31/12/2016;4;0;4
Salamanca;Kenia;31/12/2016;0;0;0
Salamanca;Kirguistán;31/12/2016;0;0;0
Salamanca;Kuwait;31/12/2016;0;0;0
Salamanca;Laos;31/12/2016;0;0;0
Salamanca;Lesoto;31/12/2016;0;0;0
Salamanca;Líbano;31/12/2016;0;0;0
Salamanca;Liberia;31/12/2016;0;0;0
Salamanca;Libia;31/12/2016;11;7;4
Salamanca;Macedonia;31/12/2016;0;0;0
Salamanca;Madagascar;31/12/2016;1;1;0
Salamanca;Malasia;31/12/2016;0;0;0
Salamanca;Malaui;31/12/2016;0;0;0
Salamanca;Maldivas;31/12/2016;0;0;0
Salamanca;Mali;31/12/2016;0;0;0
Salamanca;Marruecos;31/12/2016;16;7;9
Salamanca;Mauricio;31/12/2016;0;0;0
Salamanca;Mauritania;31/12/2016;0;0;0
Salamanca;México;31/12/2016;62;31;31
Salamanca;Micronesia;31/12/2016;0;0;0
Salamanca;Moldavia;31/12/2016;1;0;1
Salamanca;Mónaco;31/12/2016;0;0;0
Salamanca;Mongolia;31/12/2016;0;0;0
Salamanca;Montenegro;31/12/2016;0;0;0
Salamanca;Mozambique;31/12/2016;0;0;0
Salamanca;Myanmar;31/12/2016;0;0;0
Salamanca;Namibia;31/12/2016;0;0;0
Salamanca;Nepal;31/12/2016;0;0;0
Salamanca;Nicaragua;31/12/2016;5;0;5
Salamanca;Níger;31/12/2016;0;0;0
Salamanca;Nigeria;31/12/2016;1;1;0
Salamanca;Nueva Zelanda;31/12/2016;0;0;0
Salamanca;Oceanía (No consta país);31/12/2016;0;0;0
Salamanca;Omán;31/12/2016;0;0;0
Salamanca;Pakistán;31/12/2016;0;0;0
Salamanca;Palestina;31/12/2016;0;0;0
Salamanca;Panamá;31/12/2016;15;6;9
Salamanca;Papúa Nueva Guinea;31/12/2016;0;0;0
Salamanca;Paraguay;31/12/2016;6;2;4
Salamanca;Perú;31/12/2016;49;21;28
Salamanca;Qatar;31/12/2016;2;2;0
Salamanca;Reino Unido;31/12/2016;0;0;0
Salamanca;Rep. Centroafricana;31/12/2016;0;0;0
Salamanca;Rep. Dem. del Congo;31/12/2016;0;0;0
Salamanca;República Dominicana;31/12/2016;87;28;59
Salamanca;Ruanda;31/12/2016;0;0;0
Salamanca;Rusia;31/12/2016;20;4;16
Salamanca;Samoa;31/12/2016;0;0;0
Salamanca;San Cristóbal y Nieves;31/12/2016;0;0;0
Salamanca;San Marino;31/12/2016;0;0;0
Salamanca;San Vicente y Granadinas;31/12/2016;0;0;0
Salamanca;Santa Lucía;31/12/2016;0;0;0
Salamanca;Santo Tomé y Príncipe;31/12/2016;0;0;0
Salamanca;Senegal;31/12/2016;0;0;0
Salamanca;Serbia;31/12/2016;1;0;1
Salamanca;Seychelles;31/12/2016;0;0;0
Salamanca;Sierra Leona;31/12/2016;0;0;0
Salamanca;Singapur;31/12/2016;0;0;0
Salamanca;Siria;31/12/2016;2;1;1
Salamanca;Somalia;31/12/2016;0;0;0
Salamanca;Sri Lanka;31/12/2016;0;0;0
Salamanca;Suazilandia;31/12/2016;0;0;0
Salamanca;Sudáfrica;31/12/2016;1;0;1
Salamanca;Sudán;31/12/2016;0;0;0
Salamanca;Surinam;31/12/2016;0;0;0
Salamanca;Tailandia;31/12/2016;1;0;1
Salamanca;Taiwán;31/12/2016;35;3;32
Salamanca;Tanzania;31/12/2016;0;0;0
Salamanca;Tayikistán;31/12/2016;0;0;0
Salamanca;Togo;31/12/2016;0;0;0
Salamanca;Trinidad y Tobago;31/12/2016;0;0;0
Salamanca;Túnez;31/12/2016;4;2;2
Salamanca;Turkmenistán;31/12/2016;0;0;0
Salamanca;Turquía;31/12/2016;4;2;2
Salamanca;Ucrania;31/12/2016;12;2;10
Salamanca;Uganda;31/12/2016;0;0;0
Salamanca;Uruguay;31/12/2016;1;1;0
Salamanca;Uzbekistán;31/12/2016;0;0;0
Salamanca;Vanuatu;31/12/2016;0;0;0
Salamanca;Venezuela;31/12/2016;44;17;27
Salamanca;Vietnam;31/12/2016;2;0;2
Salamanca;Yemen;31/12/2016;0;0;0
Salamanca;Yibuti;31/12/2016;0;0;0
Salamanca;Zambia;31/12/2016;0;0;0
Salamanca;Zimbabue;31/12/2016;2;2;0
Salamanca;Todas las nacionalidades;31/12/2015;875;377;498
Salamanca;Afganistán;31/12/2015;0;0;0
Salamanca;Albania;31/12/2015;0;0;0
Salamanca;Andorra;31/12/2015;0;0;0
Salamanca;Angola;31/12/2015;4;2;2
Salamanca;Antigua y Barbuda;31/12/2015;0;0;0
Salamanca;Arabia Saudí;31/12/2015;14;10;4
Salamanca;Argelia;31/12/2015;3;2;1
Salamanca;Argentina;31/12/2015;6;0;6
Salamanca;Armenia;31/12/2015;0;0;0
Salamanca;Australia;31/12/2015;0;0;0
Salamanca;Azerbaiyán;31/12/2015;0;0;0
Salamanca;Bahamas;31/12/2015;0;0;0
Salamanca;Bahrein;31/12/2015;0;0;0
Salamanca;Bangladés;31/12/2015;0;0;0
Salamanca;Barbados;31/12/2015;0;0;0
Salamanca;Belice;31/12/2015;0;0;0
Salamanca;Benín;31/12/2015;1;1;0
Salamanca;Bielorrusia;31/12/2015;0;0;0
Salamanca;Bolivia;31/12/2015;10;4;6
Salamanca;Bosnia-Herzegovina;31/12/2015;0;0;0
Salamanca;Botsuana;31/12/2015;0;0;0
Salamanca;Brasil;31/12/2015;95;47;48
Salamanca;Brunei;31/12/2015;0;0;0
Salamanca;Burkina Faso;31/12/2015;0;0;0
Salamanca;Burundi;31/12/2015;0;0;0
Salamanca;Bután;31/12/2015;0;0;0
Salamanca;Cabo Verde;31/12/2015;0;0;0
Salamanca;Camboya;31/12/2015;0;0;0
Salamanca;Camerún;31/12/2015;1;1;0
Salamanca;Canadá;31/12/2015;0;0;0
Salamanca;Chad;31/12/2015;1;1;0
Salamanca;Chile;31/12/2015;14;7;7
Salamanca;China;31/12/2015;306;102;204
Salamanca;Colombia;31/12/2015;66;32;34
Salamanca;Comores;31/12/2015;0;0;0
Salamanca;Congo;31/12/2015;0;0;0
Salamanca;Corea del Norte;31/12/2015;0;0;0
Salamanca;Corea del Sur;31/12/2015;31;12;19
Salamanca;Costa de Marfil;31/12/2015;3;3;0
Salamanca;Costa Rica;31/12/2015;4;2;2
Salamanca;Cuba;31/12/2015;1;1;0
Salamanca;Dominica;31/12/2015;0;0;0
Salamanca;Ecuador;31/12/2015;23;11;12
Salamanca;Egipto;31/12/2015;2;0;2
Salamanca;El Salvador;31/12/2015;4;1;3
Salamanca;Emiratos Árabes Unidos;31/12/2015;0;0;0
Salamanca;Eritrea;31/12/2015;0;0;0
Salamanca;Estados Unidos;31/12/2015;30;9;21
Salamanca;Etiopía;31/12/2015;0;0;0
Salamanca;Filipinas;31/12/2015;2;1;1
Salamanca;Fiyi;31/12/2015;0;0;0
Salamanca;Gabón;31/12/2015;1;1;0
Salamanca;Gambia;31/12/2015;0;0;0
Salamanca;Georgia;31/12/2015;0;0;0
Salamanca;Ghana;31/12/2015;0;0;0
Salamanca;Granada;31/12/2015;0;0;0
Salamanca;Guatemala;31/12/2015;3;1;2
Salamanca;Guinea;31/12/2015;0;0;0
Salamanca;Guinea Bissau;31/12/2015;0;0;0
Salamanca;Guinea Ecuatorial;31/12/2015;35;18;17
Salamanca;Guyana;31/12/2015;0;0;0
Salamanca;Haití;31/12/2015;0;0;0
Salamanca;Honduras;31/12/2015;4;3;1
Salamanca;India;31/12/2015;2;0;2
Salamanca;Indonesia;31/12/2015;1;1;0
Salamanca;Irak;31/12/2015;0;0;0
Salamanca;Irán;31/12/2015;4;0;4
Salamanca;Islas Salomón;31/12/2015;0;0;0
Salamanca;Israel;31/12/2015;1;0;1
Salamanca;Jamaica;31/12/2015;0;0;0
Salamanca;Japón;31/12/2015;13;6;7
Salamanca;Jordania;31/12/2015;1;0;1
Salamanca;Kazajistán;31/12/2015;3;0;3
Salamanca;Kenia;31/12/2015;0;0;0
Salamanca;Kirguistán;31/12/2015;0;0;0
Salamanca;Kuwait;31/12/2015;0;0;0
Salamanca;Laos;31/12/2015;0;0;0
Salamanca;Lesoto;31/12/2015;0;0;0
Salamanca;Líbano;31/12/2015;0;0;0
Salamanca;Liberia;31/12/2015;0;0;0
Salamanca;Libia;31/12/2015;6;5;1
Salamanca;Macedonia;31/12/2015;0;0;0
Salamanca;Madagascar;31/12/2015;0;0;0
Salamanca;Malasia;31/12/2015;0;0;0
Salamanca;Malaui;31/12/2015;0;0;0
Salamanca;Maldivas;31/12/2015;0;0;0
Salamanca;Mali;31/12/2015;0;0;0
Salamanca;Marruecos;31/12/2015;23;13;10
Salamanca;Mauricio;31/12/2015;0;0;0
Salamanca;Mauritania;31/12/2015;0;0;0
Salamanca;México;31/12/2015;32;20;12
Salamanca;Micronesia;31/12/2015;0;0;0
Salamanca;Moldavia;31/12/2015;0;0;0
Salamanca;Mónaco;31/12/2015;0;0;0
Salamanca;Mongolia;31/12/2015;0;0;0
Salamanca;Montenegro;31/12/2015;0;0;0
Salamanca;Mozambique;31/12/2015;0;0;0
Salamanca;Myanmar;31/12/2015;0;0;0
Salamanca;Namibia;31/12/2015;0;0;0
Salamanca;Nepal;31/12/2015;0;0;0
Salamanca;Nicaragua;31/12/2015;1;0;1
Salamanca;Níger;31/12/2015;0;0;0
Salamanca;Nigeria;31/12/2015;1;1;0
Salamanca;Nueva Zelanda;31/12/2015;1;0;1
Salamanca;Oceanía (No consta país);31/12/2015;0;0;0
Salamanca;Omán;31/12/2015;0;0;0
Salamanca;Pakistán;31/12/2015;0;0;0
Salamanca;Palestina;31/12/2015;0;0;0
Salamanca;Panamá;31/12/2015;2;1;1
Salamanca;Papúa Nueva Guinea;31/12/2015;0;0;0
Salamanca;Paraguay;31/12/2015;2;1;1
Salamanca;Perú;31/12/2015;30;16;14
Salamanca;Qatar;31/12/2015;2;2;0
Salamanca;Reino Unido;31/12/2015;0;0;0
Salamanca;Rep. Centroafricana;31/12/2015;0;0;0
Salamanca;Rep. Dem. del Congo;31/12/2015;0;0;0
Salamanca;República Dominicana;31/12/2015;21;12;9
Salamanca;Ruanda;31/12/2015;0;0;0
Salamanca;Rusia;31/12/2015;13;4;9
Salamanca;Samoa;31/12/2015;0;0;0
Salamanca;San Cristóbal y Nieves;31/12/2015;0;0;0
Salamanca;San Marino;31/12/2015;0;0;0
Salamanca;San Vicente y Granadinas;31/12/2015;0;0;0
Salamanca;Santa Lucía;31/12/2015;0;0;0
Salamanca;Santo Tomé y Príncipe;31/12/2015;0;0;0
Salamanca;Senegal;31/12/2015;1;1;0
Salamanca;Serbia;31/12/2015;0;0;0
Salamanca;Seychelles;31/12/2015;0;0;0
Salamanca;Sierra Leona;31/12/2015;0;0;0
Salamanca;Singapur;31/12/2015;0;0;0
Salamanca;Siria;31/12/2015;2;1;1
Salamanca;Somalia;31/12/2015;0;0;0
Salamanca;Sri Lanka;31/12/2015;0;0;0
Salamanca;Suazilandia;31/12/2015;0;0;0
Salamanca;Sudáfrica;31/12/2015;3;1;2
Salamanca;Sudán;31/12/2015;1;1;0
Salamanca;Surinam;31/12/2015;0;0;0
Salamanca;Tailandia;31/12/2015;3;0;3
Salamanca;Taiwán;31/12/2015;5;1;4
Salamanca;Tanzania;31/12/2015;0;0;0
Salamanca;Tayikistán;31/12/2015;0;0;0
Salamanca;Togo;31/12/2015;0;0;0
Salamanca;Trinidad y Tobago;31/12/2015;0;0;0
Salamanca;Túnez;31/12/2015;1;0;1
Salamanca;Turkmenistán;31/12/2015;0;0;0
Salamanca;Turquía;31/12/2015;1;1;0
Salamanca;Ucrania;31/12/2015;6;1;5
Salamanca;Uganda;31/12/2015;0;0;0
Salamanca;Uruguay;31/12/2015;1;1;0
Salamanca;Uzbekistán;31/12/2015;0;0;0
Salamanca;Vanuatu;31/12/2015;0;0;0
Salamanca;Venezuela;31/12/2015;25;13;12
Salamanca;Vietnam;31/12/2015;2;1;1
Salamanca;Yemen;31/12/2015;0;0;0
Salamanca;Yibuti;31/12/2015;0;0;0
Salamanca;Zambia;31/12/2015;0;0;0
Salamanca;Zimbabue;31/12/2015;1;1;0
